chr	start	end	id	length	strand	CPM_atac_0	CPM_h3k27ac_0
chr22	16192759	16193259	0	500	+	0.0	0.0
chr22	16197565	16198065	1	500	+	12.809444146980686	0.0
chr22	16204925	16205425	2	500	+	7.685666488188412	0.0
chr22	16231039	16231539	3	500	+	2.561888829396137	0.0
chr22	16263325	16263825	4	500	+	23.056999464565237	0.0
chr22	16287687	16288187	5	500	+	0.0	0.0
chr22	16449554	16450054	6	500	+	0.0	0.0
chr22	16928205	16928705	7	500	+	23.056999464565237	9.140475396125353
chr22	17030525	17031025	8	500	+	28.180777123357508	4.570237698062677
chr22	17038205	17038705	9	500	+	35.86644361154592	13.710713094188028
chr22	17049445	17049945	10	500	+	30.742665952753647	27.421426188376056
chr22	17067005	17067605	11	600	+	169.08466274014506	4.570237698062677
chr22	17067825	17068345	12	520	+	35.86644361154592	31.991663886438737
chr22	17068605	17069105	13	500	+	25.618888293961373	0.0
chr22	17073450	17073950	14	500	+	20.495110635169095	18.280950792250707
chr22	17080325	17081105	15	780	+	320.23610367451715	73.12380316900283
chr22	17081265	17081885	16	620	+	140.90388561678753	210.23093411088308
chr22	17081945	17083145	17	1200	+	801.8712036009908	374.7594912411395
chr22	17083825	17085245	18	1420	+	381.72143558002443	740.3785070861535
chr22	17085385	17086045	19	660	+	94.78988668765707	86.83451626319085
chr22	17086065	17086725	20	660	+	146.0276632755798	4.570237698062677
chr22	17096625	17097465	21	840	+	64.04722073490342	9.140475396125353
chr22	17098345	17098845	22	500	+	48.675887758526606	0.0
chr22	17105285	17105825	23	540	+	81.98044254067638	9.140475396125353
chr22	17132565	17133065	24	500	+	17.93322180577296	4.570237698062677
chr22	17134965	17135465	25	500	+	74.29477605248798	22.85118849031338
chr22	17136305	17136805	26	500	+	25.618888293961373	4.570237698062677
chr22	17137225	17137725	27	500	+	40.99022127033819	9.140475396125353
chr22	17138805	17139305	28	500	+	48.675887758526606	0.0
chr22	17156180	17156680	29	500	+	7.685666488188412	9.140475396125353
chr22	17198765	17199325	30	560	+	64.04722073490342	13.710713094188028
chr22	17217485	17217985	31	500	+	20.495110635169095	0.0
chr22	17228285	17228805	32	520	+	48.675887758526606	0.0
chr22	17229078	17229578	33	500	+	7.685666488188412	4.570237698062677
chr22	17239545	17240045	34	500	+	38.42833244094206	4.570237698062677
chr22	17255425	17256405	35	980	+	335.607436650894	50.27261467868944
chr22	17256825	17257325	36	500	+	51.237776587922745	0.0
chr22	17262245	17262765	37	520	+	158.8371074225605	100.54522935737889
chr22	17264625	17265145	38	520	+	115.28499732282617	41.13213928256408
chr22	17276325	17276825	39	500	+	46.113998929130474	41.13213928256408
chr22	17289265	17289765	40	500	+	35.86644361154592	18.280950792250707
chr22	17296345	17296845	41	500	+	46.113998929130474	0.0
chr22	17302339	17302839	42	500	+	5.123777658792274	0.0
chr22	17306045	17306645	43	600	+	66.60910956429957	68.55356547094014
chr22	17308113	17308613	44	500	+	0.0	4.570237698062677
chr22	17372825	17373325	45	500	+	30.742665952753647	0.0
chr22	17398225	17398745	46	520	+	125.53255264041073	13.710713094188028
chr22	17403065	17403565	47	500	+	33.304554782149786	9.140475396125353
chr22	17488862	17489362	48	500	+	7.685666488188412	0.0
chr22	17505185	17505685	49	500	+	20.495110635169095	0.0
chr22	17514965	17515465	50	500	+	7.685666488188412	9.140475396125353
chr22	17517209	17517709	51	500	+	5.123777658792274	0.0
chr22	17518105	17519005	52	900	+	53.79966541731888	45.70237698062676
chr22	17519145	17519645	53	500	+	43.552110099734335	13.710713094188028
chr22	17538985	17539505	54	520	+	35.86644361154592	4.570237698062677
chr22	17544525	17545025	55	500	+	25.618888293961373	13.710713094188028
chr22	17548965	17549465	56	500	+	30.742665952753647	4.570237698062677
chr22	17555705	17556225	57	520	+	51.237776587922745	0.0
chr22	17565485	17566098	58	613	+	440.64487865613563	173.6690325263817
chr22	17568545	17569065	59	520	+	105.03744200524163	22.85118849031338
chr22	17579325	17579825	60	500	+	122.97066381101459	13.710713094188028
chr22	17583125	17583645	61	520	+	107.59933083463775	31.991663886438737
chr22	17601145	17601645	62	500	+	23.056999464565237	4.570237698062677
chr22	17602007	17602734	63	727	+	15.371332976376824	0.0
chr22	17636745	17637265	64	520	+	243.37943879263304	0.0
chr22	17639305	17640528	65	1223	+	215.1986616692755	114.25594245156691
chr22	17645927	17646427	66	500	+	15.371332976376824	13.710713094188028
chr22	17651945	17652465	67	520	+	228.0081058162562	73.12380316900283
chr22	17652565	17653365	68	800	+	240.8175499632369	100.54522935737889
chr22	17671985	17672545	69	560	+	30.742665952753647	0.0
chr22	17679445	17680025	70	580	+	43.552110099734335	18.280950792250707
chr22	17682045	17682585	71	540	+	115.28499732282617	4.570237698062677
chr22	17684165	17684805	72	640	+	38.42833244094206	9.140475396125353
chr22	17694805	17695365	73	560	+	69.17099839369571	4.570237698062677
chr22	17700225	17700725	74	500	+	10.247555317584547	13.710713094188028
chr22	17724245	17724765	75	520	+	64.04722073490342	4.570237698062677
chr22	17738925	17739525	76	600	+	148.58955210497595	4.570237698062677
chr22	17741705	17742285	77	580	+	61.485331905507294	22.85118849031338
chr22	17747373	17747873	78	500	+	5.123777658792274	9.140475396125353
chr22	17749305	17749965	79	660	+	71.73288722309184	4.570237698062677
chr22	17756265	17756825	80	560	+	81.98044254067638	4.570237698062677
chr22	17788365	17788865	81	500	+	43.552110099734335	18.280950792250707
chr22	17796145	17796865	82	720	+	58.923443076111155	36.56190158450141
chr22	17800385	17800905	83	520	+	33.304554782149786	13.710713094188028
chr22	17819905	17820405	84	500	+	51.237776587922745	18.280950792250707
chr22	17827845	17828385	85	540	+	156.27521859316437	13.710713094188028
chr22	17839365	17839865	86	500	+	43.552110099734335	18.280950792250707
chr22	17840325	17841088	87	763	+	637.9103185196382	36.56190158450141
chr22	17847245	17848245	88	1000	+	207.51299518108712	36.56190158450141
chr22	17848445	17848965	89	520	+	79.41855371128025	18.280950792250707
chr22	17849445	17850005	90	560	+	215.1986616692755	13.710713094188028
chr22	17851345	17851905	91	560	+	58.923443076111155	9.140475396125353
chr22	17854005	17854505	92	500	+	10.247555317584547	13.710713094188028
chr22	17856805	17857385	93	580	+	48.675887758526606	0.0
chr22	17859165	17860085	94	920	+	443.20676748553177	27.421426188376056
chr22	17864765	17865285	95	520	+	79.41855371128025	9.140475396125353
chr22	17869945	17870445	96	500	+	2.561888829396137	9.140475396125353
chr22	17890245	17890765	97	520	+	33.304554782149786	13.710713094188028
chr22	17891925	17892465	98	540	+	61.485331905507294	13.710713094188028
chr22	17893105	17893605	99	500	+	10.247555317584547	0.0
chr22	17900665	17901385	100	720	+	120.40877498161845	9.140475396125353
chr22	17902025	17902525	101	500	+	128.09444146980684	13.710713094188028
chr22	17909505	17910005	102	500	+	33.304554782149786	13.710713094188028
chr22	17910165	17910665	103	500	+	23.056999464565237	9.140475396125353
chr22	17912545	17913065	104	520	+	69.17099839369571	13.710713094188028
chr22	17915625	17916605	105	980	+	417.5878791915704	31.991663886438737
chr22	17917145	17917645	106	500	+	23.056999464565237	0.0
chr22	17921725	17922325	107	600	+	69.17099839369571	9.140475396125353
chr22	17922505	17923005	108	500	+	276.68399357478285	13.710713094188028
chr22	17928665	17929225	109	560	+	58.923443076111155	9.140475396125353
chr22	17936705	17937205	110	500	+	43.552110099734335	4.570237698062677
chr22	17938865	17939365	111	500	+	48.675887758526606	0.0
chr22	17945845	17946425	112	580	+	43.552110099734335	9.140475396125353
chr22	17948345	17948845	113	500	+	23.056999464565237	9.140475396125353
chr22	17949285	17949785	114	500	+	10.247555317584547	4.570237698062677
chr22	17950805	17951345	115	540	+	43.552110099734335	4.570237698062677
chr22	17955845	17956345	116	500	+	66.60910956429957	9.140475396125353
chr22	17956365	17956925	117	560	+	107.59933083463775	13.710713094188028
chr22	17965205	17965785	118	580	+	40.99022127033819	13.710713094188028
chr22	17980625	17981145	119	520	+	146.0276632755798	13.710713094188028
chr22	18009205	18009705	120	500	+	38.42833244094206	4.570237698062677
chr22	18038045	18038565	121	520	+	33.304554782149786	22.85118849031338
chr22	18042105	18043388	122	1283	+	312.55043718632874	36.56190158450141
chr22	18049605	18050105	123	500	+	30.742665952753647	22.85118849031338
chr22	18051085	18051645	124	560	+	51.237776587922745	54.84285237675211
chr22	18056505	18057025	125	520	+	48.675887758526606	41.13213928256408
chr22	18060845	18061345	126	500	+	28.180777123357508	18.280950792250707
chr22	18062905	18063405	127	500	+	166.52277391074892	22.85118849031338
chr22	18071708	18072208	128	500	+	10.247555317584547	0.0
chr22	18106345	18106845	129	500	+	53.79966541731888	9.140475396125353
chr22	18111338	18112145	130	807	+	1242.5160822571265	1448.7653502858684
chr22	18114005	18114505	131	500	+	33.304554782149786	27.421426188376056
chr22	18114565	18115385	132	820	+	56.361554246715016	105.11546705544154
chr22	18115825	18116325	133	500	+	640.4722073490343	626.1225646345866
chr22	18116485	18116985	134	500	+	107.59933083463775	415.89163052370355
chr22	18117445	18117985	135	540	+	58.923443076111155	54.84285237675211
chr22	18120105	18120765	136	660	+	84.54233137007253	361.0487781469514
chr22	18121099	18121705	137	606	+	653.281651496015	1663.5665220948142
chr22	18122085	18122785	138	700	+	156.27521859316437	1115.137998327293
chr22	18155285	18156285	139	1000	+	386.8452132388167	319.9166388643873
chr22	18156585	18157145	140	560	+	81.98044254067638	77.6940408670655
chr22	18189225	18189765	141	540	+	69.17099839369571	54.84285237675211
chr22	18195185	18195725	142	540	+	61.485331905507294	27.421426188376056
chr22	18204765	18205265	143	500	+	51.237776587922745	22.85118849031338
chr22	18207525	18208045	144	520	+	69.17099839369571	59.41309007481479
chr22	18213205	18213805	145	600	+	56.361554246715016	18.280950792250707
chr22	18225125	18225625	146	500	+	133.21821912859915	36.56190158450141
chr22	18255925	18256445	147	520	+	128.09444146980684	50.27261467868944
chr22	18256485	18256985	148	500	+	56.361554246715016	59.41309007481479
chr22	18257011	18257605	149	594	+	43.552110099734335	63.98332777287747
chr22	18259805	18260445	150	640	+	197.26543986350256	274.21426188376057
chr22	18262105	18262625	151	520	+	197.26543986350256	27.421426188376056
chr22	18264005	18264505	152	500	+	69.17099839369571	27.421426188376056
chr22	18267905	18268445	153	540	+	135.78010795799528	27.421426188376056
chr22	18269125	18270105	154	980	+	847.9852025301213	420.46186822176617
chr22	18271185	18271765	155	580	+	38.42833244094206	41.13213928256408
chr22	18275685	18276225	156	540	+	40.99022127033819	18.280950792250707
chr22	18280845	18281365	157	520	+	48.675887758526606	31.991663886438737
chr22	18285565	18286105	158	540	+	46.113998929130474	27.421426188376056
chr22	18312685	18313185	159	500	+	153.71332976376823	13.710713094188028
chr22	18330105	18330625	160	520	+	89.6661090288648	4.570237698062677
chr22	18335865	18336425	161	560	+	74.29477605248798	13.710713094188028
chr22	18350045	18350605	162	560	+	35.86644361154592	18.280950792250707
chr22	18355205	18355705	163	500	+	17.93322180577296	0.0
chr22	18371545	18372085	164	540	+	79.41855371128025	22.85118849031338
chr22	18372985	18373505	165	520	+	46.113998929130474	22.85118849031338
chr22	18374385	18374885	166	500	+	28.180777123357508	27.421426188376056
chr22	18389402	18389902	167	500	+	15.371332976376824	13.710713094188028
chr22	18393265	18393785	168	520	+	56.361554246715016	27.421426188376056
chr22	18396585	18397145	169	560	+	215.1986616692755	4.570237698062677
chr22	18398885	18399385	170	500	+	663.5292068135994	182.80950792250704
chr22	18400325	18400825	171	500	+	456.0162116325124	187.37974562056974
chr22	18402985	18403505	172	520	+	304.8647706981403	82.26427856512817
chr22	18403725	18404225	173	500	+	102.47555317584549	22.85118849031338
chr22	18404665	18405165	174	500	+	112.72310849343003	9.140475396125353
chr22	18405845	18406345	175	500	+	40.99022127033819	9.140475396125353
chr22	18433245	18433745	176	500	+	40.99022127033819	13.710713094188028
chr22	18448185	18448725	177	540	+	89.6661090288648	9.140475396125353
chr22	18452985	18453485	178	500	+	279.24588240417893	27.421426188376056
chr22	18462745	18463245	179	500	+	53.79966541731888	137.10713094188029
chr22	18463265	18463765	180	500	+	612.2914302256768	105.11546705544154
chr22	18482965	18483465	181	500	+	30.742665952753647	22.85118849031338
chr22	18484305	18484845	182	540	+	922.2799785826094	909.4773019144726
chr22	18506165	18506725	183	560	+	181.89410688712573	27.421426188376056
chr22	18507105	18507865	184	760	+	140.90388561678753	36.56190158450141
chr22	18511900	18512400	185	500	+	25.618888293961373	9.140475396125353
chr22	18525025	18525605	186	580	+	35.86644361154592	18.280950792250707
chr22	18531225	18531725	187	500	+	46.113998929130474	27.421426188376056
chr22	18535185	18535685	188	500	+	15.371332976376824	9.140475396125353
chr22	18536945	18537445	189	500	+	38.42833244094206	18.280950792250707
chr22	18538445	18539365	190	920	+	153.71332976376823	41.13213928256408
chr22	18540365	18540865	191	500	+	81.98044254067638	4.570237698062677
chr22	18558745	18559245	192	500	+	417.5878791915704	27.421426188376056
chr22	18559485	18560085	193	600	+	51.237776587922745	63.98332777287747
chr22	18560425	18560935	194	510	+	481.6350999264738	274.21426188376057
chr22	18561285	18561785	195	500	+	28.180777123357508	118.82618014962958
chr22	18589745	18590305	196	560	+	92.22799785826095	22.85118849031338
chr22	18593202	18593702	197	500	+	0.0	0.0
chr22	18628685	18629185	198	500	+	23.056999464565237	22.85118849031338
chr22	18632445	18633125	199	680	+	120.40877498161845	9.140475396125353
chr22	18638725	18639225	200	500	+	30.742665952753647	0.0
chr22	18639865	18640365	201	500	+	99.91366434644934	4.570237698062677
chr22	18667997	18668497	202	500	+	0.0	0.0
chr22	18688380	18688880	203	500	+	0.0	0.0
chr22	18721176	18721676	204	500	+	7.685666488188412	0.0
chr22	18779224	18779724	205	500	+	0.0	0.0
chr22	18837380	18837880	206	500	+	0.0	0.0
chr22	18841505	18842125	207	620	+	230.56999464565234	0.0
chr22	18846705	18847305	208	600	+	48.675887758526606	0.0
chr22	18881694	18882194	209	500	+	10.247555317584547	0.0
chr22	18892225	18892725	210	500	+	51.237776587922745	4.570237698062677
chr22	18893485	18894025	211	540	+	448.330545144324	127.96665554575495
chr22	18894365	18894865	212	500	+	89.6661090288648	22.85118849031338
chr22	18913885	18914405	213	520	+	40.99022127033819	0.0
chr22	18916865	18917365	214	500	+	25.618888293961373	0.0
chr22	18923714	18924214	215	500	+	17.93322180577296	4.570237698062677
chr22	18941805	18942385	216	580	+	30.742665952753647	9.140475396125353
chr22	18946225	18946725	217	500	+	35.86644361154592	9.140475396125353
chr22	18955625	18956125	218	500	+	53.79966541731888	22.85118849031338
chr22	18957760	18958260	219	500	+	7.685666488188412	4.570237698062677
chr22	18975225	18975745	220	520	+	99.91366434644934	13.710713094188028
chr22	18976625	18977285	221	660	+	92.22799785826095	4.570237698062677
chr22	18986465	18986985	222	520	+	94.78988668765707	41.13213928256408
chr22	18989785	18990625	223	840	+	166.52277391074892	31.991663886438737
chr22	19005065	19005596	224	531	+	48.675887758526606	13.710713094188028
chr22	19009886	19010665	225	779	+	56.361554246715016	27.421426188376056
chr22	19014825	19015325	226	500	+	46.113998929130474	4.570237698062677
chr22	19023125	19023645	227	520	+	125.53255264041073	9.140475396125353
chr22	19024405	19024905	228	500	+	74.29477605248798	4.570237698062677
chr22	19035638	19036138	229	500	+	23.056999464565237	59.41309007481479
chr22	19038825	19039345	230	520	+	102.47555317584549	36.56190158450141
chr22	19040665	19041165	231	500	+	20.495110635169095	68.55356547094014
chr22	19044245	19044745	232	500	+	35.86644361154592	27.421426188376056
chr22	19061205	19061725	233	520	+	56.361554246715016	31.991663886438737
chr22	19072565	19073105	234	540	+	156.27521859316437	50.27261467868944
chr22	19073145	19073745	235	600	+	94.78988668765707	45.70237698062676
chr22	19073965	19074865	236	900	+	148.58955210497595	150.8178440360683
chr22	19083165	19083665	237	500	+	38.42833244094206	22.85118849031338
chr22	19093745	19094245	238	500	+	56.361554246715016	36.56190158450141
chr22	19096305	19096805	239	500	+	248.50321645142532	260.5035487895725
chr22	19096845	19097345	240	500	+	1634.4850731547356	306.2059257701993
chr22	19097405	19098025	241	620	+	258.7507717690098	525.5773352772078
chr22	19098265	19099285	242	1020	+	179.3322180577296	370.18925354307675
chr22	19102205	19102705	243	500	+	71.73288722309184	63.98332777287747
chr22	19103085	19103585	244	500	+	71.73288722309184	91.40475396125352
chr22	19105725	19106225	245	500	+	43.552110099734335	54.84285237675211
chr22	19108945	19109485	246	540	+	207.51299518108712	411.3213928256409
chr22	19109717	19110705	247	988	+	1824.0648465300496	287.9249749779486
chr22	19111405	19111925	248	520	+	130.65633029920298	63.98332777287747
chr22	19118070	19118570	249	500	+	38.42833244094206	27.421426188376056
chr22	19131325	19131885	250	560	+	133.21821912859915	429.60234361789156
chr22	19131940	19132585	251	645	+	3525.159029249085	260.5035487895725
chr22	19133605	19134145	252	540	+	156.27521859316437	36.56190158450141
chr22	19137546	19138046	253	500	+	0.0	0.0
chr22	19140585	19141525	254	940	+	135.78010795799528	77.6940408670655
chr22	19147725	19148225	255	500	+	69.17099839369571	45.70237698062676
chr22	19153865	19154425	256	560	+	79.41855371128025	45.70237698062676
chr22	19155525	19156045	257	520	+	92.22799785826095	50.27261467868944
chr22	19156925	19157505	258	580	+	202.38921752229484	63.98332777287747
chr22	19158185	19158705	259	520	+	122.97066381101459	383.8999666372648
chr22	19158925	19159468	260	543	+	725.0145387191068	950.6094411970366
chr22	19159585	19160085	261	500	+	46.113998929130474	612.4118515403986
chr22	19160385	19160985	262	600	+	128.09444146980684	301.6356880721366
chr22	19161025	19161525	263	500	+	61.485331905507294	155.388081734131
chr22	19161985	19162505	264	520	+	102.47555317584549	95.9749916593162
chr22	19163265	19164765	265	1500	+	394.53087972700513	420.46186822176617
chr22	19165725	19166685	266	960	+	1378.296190215122	584.9904253520226
chr22	19166845	19167345	267	500	+	822.3663142361601	233.0821226011965
chr22	19172465	19173005	268	540	+	192.1416622047103	27.421426188376056
chr22	19191165	19191665	269	500	+	48.675887758526606	13.710713094188028
chr22	19194825	19195385	270	560	+	61.485331905507294	13.710713094188028
chr22	19195665	19196185	271	520	+	94.78988668765707	22.85118849031338
chr22	19205345	19205865	272	520	+	1639.6088508135279	137.10713094188029
chr22	19205905	19206805	273	900	+	207.51299518108712	169.09879482831903
chr22	19217045	19217545	274	500	+	58.923443076111155	27.421426188376056
chr22	19220745	19221245	275	500	+	69.17099839369571	50.27261467868944
chr22	19232265	19232765	276	500	+	192.1416622047103	63.98332777287747
chr22	19247105	19247705	277	600	+	122.97066381101459	260.5035487895725
chr22	19254005	19254505	278	500	+	64.04722073490342	4.570237698062677
chr22	19263345	19263845	279	500	+	491.88265524405836	41.13213928256408
chr22	19274625	19275125	280	500	+	43.552110099734335	36.56190158450141
chr22	19277285	19277785	281	500	+	258.7507717690098	59.41309007481479
chr22	19277845	19278745	282	900	+	309.9885483569326	159.95831943219366
chr22	19278965	19280005	283	1040	+	768.5666488188411	840.9237364435323
chr22	19283805	19284445	284	640	+	97.35177551705321	13.710713094188028
chr22	19287445	19287945	285	500	+	412.4641015327781	22.85118849031338
chr22	19293145	19293685	286	540	+	53.79966541731888	18.280950792250707
chr22	19303465	19303965	287	500	+	94.78988668765707	4.570237698062677
chr22	19304165	19304685	288	520	+	97.35177551705321	18.280950792250707
chr22	19316085	19316585	289	500	+	51.237776587922745	13.710713094188028
chr22	19321125	19321645	290	520	+	133.21821912859915	9.140475396125353
chr22	19358285	19358785	291	500	+	51.237776587922745	54.84285237675211
chr22	19359585	19360085	292	500	+	69.17099839369571	0.0
chr22	19377905	19378405	293	500	+	48.675887758526606	41.13213928256408
chr22	19383985	19385005	294	1020	+	2423.5468326087457	2143.4414803913955
chr22	19385185	19385685	295	500	+	271.56021591599057	790.651121764843
chr22	19386125	19386625	296	500	+	94.78988668765707	223.94164720507112
chr22	19390585	19391085	297	500	+	176.77032922833345	41.13213928256408
chr22	19393765	19394285	298	520	+	89.6661090288648	45.70237698062676
chr22	19395665	19396185	299	520	+	309.9885483569326	159.95831943219366
chr22	19406545	19407045	300	500	+	1870.1788454591801	310.776163468262
chr22	19407125	19407645	301	520	+	1214.335305133769	287.9249749779486
chr22	19409805	19410365	302	560	+	115.28499732282617	191.9499833186324
chr22	19416985	19417485	303	500	+	79.41855371128025	118.82618014962958
chr22	19417845	19419674	304	1829	+	1360.3629684093487	2088.598628014643
chr22	19419705	19420205	305	500	+	2141.739061375171	1051.1546705544156
chr22	19420585	19421085	306	500	+	466.26376695009697	228.51188490313382
chr22	19429545	19430085	307	540	+	94.78988668765707	118.82618014962958
chr22	19432545	19433045	308	500	+	76.85666488188411	36.56190158450141
chr22	19434325	19434925	309	600	+	161.39899625195665	525.5773352772078
chr22	19435025	19436045	310	1020	+	1478.209854561571	868.3451626319085
chr22	19441605	19442105	311	500	+	87.10422019946867	45.70237698062676
chr22	19450965	19451485	312	520	+	120.40877498161845	9.140475396125353
chr22	19463345	19463845	313	500	+	23.056999464565237	100.54522935737889
chr22	19465045	19466325	314	1280	+	394.53087972700513	1412.203448701367
chr22	19466488	19467598	315	1110	+	5333.852542802758	4328.015100065355
chr22	19467845	19468825	316	980	+	292.0553265511596	552.9987614655838
chr22	19476645	19477205	317	560	+	112.72310849343003	31.991663886438737
chr22	19484685	19485245	318	560	+	138.34199678739142	95.9749916593162
chr22	19491365	19491865	319	500	+	81.98044254067638	41.13213928256408
chr22	19504865	19505365	320	500	+	33.304554782149786	54.84285237675211
chr22	19510465	19510965	321	500	+	43.552110099734335	9.140475396125353
chr22	19512610	19513110	322	500	+	28.180777123357508	13.710713094188028
chr22	19514025	19514525	323	500	+	46.113998929130474	27.421426188376056
chr22	19514885	19515425	324	540	+	79.41855371128025	18.280950792250707
chr22	19515605	19516125	325	520	+	48.675887758526606	27.421426188376056
chr22	19522485	19523025	326	540	+	84.54233137007253	22.85118849031338
chr22	19529025	19529525	327	500	+	51.237776587922745	31.991663886438737
chr22	19546685	19547185	328	500	+	76.85666488188411	77.6940408670655
chr22	19554112	19554612	329	500	+	38.42833244094206	22.85118849031338
chr22	19560845	19561345	330	500	+	53.79966541731888	45.70237698062676
chr22	19563865	19564765	331	900	+	371.47388026243993	73.12380316900283
chr22	19565605	19566105	332	500	+	837.7376472125369	31.991663886438737
chr22	19569825	19570325	333	500	+	207.51299518108712	50.27261467868944
chr22	19570865	19571365	334	500	+	46.113998929130474	31.991663886438737
chr22	19575705	19576225	335	520	+	66.60910956429957	22.85118849031338
chr22	19592245	19592765	336	520	+	292.0553265511596	59.41309007481479
chr22	19600665	19601625	337	960	+	220.32243932806782	54.84285237675211
chr22	19602405	19602965	338	560	+	69.17099839369571	68.55356547094014
chr22	19603665	19604565	339	900	+	128.09444146980684	27.421426188376056
chr22	19609645	19610145	340	500	+	51.237776587922745	36.56190158450141
chr22	19615005	19615845	341	840	+	146.0276632755798	338.19758965663806
chr22	19617385	19617885	342	500	+	468.8256557794931	36.56190158450141
chr22	19618645	19619165	343	520	+	69.17099839369571	13.710713094188028
chr22	19619605	19620125	344	520	+	312.55043718632874	86.83451626319085
chr22	19621325	19621845	345	520	+	184.4559957165219	95.9749916593162
chr22	19628845	19629365	346	520	+	279.24588240417893	114.25594245156691
chr22	19630945	19631445	347	500	+	1186.1545280104115	214.80117180894578
chr22	19631645	19632145	348	500	+	140.90388561678753	278.78449958182324
chr22	19635785	19636385	349	600	+	199.82732869289867	27.421426188376056
chr22	19649385	19649945	350	560	+	69.17099839369571	9.140475396125353
chr22	19651445	19651965	351	520	+	181.89410688712573	27.421426188376056
chr22	19661845	19662385	352	540	+	69.17099839369571	36.56190158450141
chr22	19667045	19667545	353	500	+	169.08466274014506	31.991663886438737
chr22	19669745	19670705	354	960	+	112.72310849343003	41.13213928256408
chr22	19678665	19679165	355	500	+	230.56999464565234	36.56190158450141
chr22	19679225	19679765	356	540	+	976.0796439999283	489.0154336927064
chr22	19683185	19683705	357	520	+	522.6253211968119	63.98332777287747
chr22	19689385	19689885	358	500	+	40.99022127033819	4.570237698062677
chr22	19696725	19697225	359	500	+	76.85666488188411	27.421426188376056
chr22	19700945	19701445	360	500	+	87.10422019946867	45.70237698062676
chr22	19701545	19702065	361	520	+	102.47555317584549	41.13213928256408
chr22	19704492	19706207	362	1715	+	537.9966541731889	1005.4522935737888
chr22	19706385	19706885	363	500	+	189.57977337531415	493.585671390769
chr22	19709605	19710505	364	900	+	1224.5828604513536	712.9570808977775
chr22	19710705	19711315	365	610	+	2664.364382571983	1087.716572138917
chr22	19711525	19712785	366	1260	+	696.8337615957494	653.5439908229627
chr22	19712905	19713405	367	500	+	161.39899625195665	123.39641784769225
chr22	19714805	19715685	368	880	+	117.84688615222231	77.6940408670655
chr22	19718065	19718845	369	780	+	740.3858716954837	196.52022101669507
chr22	19719245	19719745	370	500	+	35.86644361154592	45.70237698062676
chr22	19722005	19722505	371	500	+	74.29477605248798	31.991663886438737
chr22	19736385	19736965	372	580	+	156.27521859316437	31.991663886438737
chr22	19740965	19741465	373	500	+	69.17099839369571	36.56190158450141
chr22	19743975	19744505	374	530	+	309.9885483569326	36.56190158450141
chr22	19745105	19745625	375	520	+	69.17099839369571	41.13213928256408
chr22	19747565	19748145	376	580	+	158.8371074225605	54.84285237675211
chr22	19749285	19749865	377	580	+	130.65633029920298	201.09045871475777
chr22	19749885	19750585	378	700	+	146.0276632755798	255.9333110915099
chr22	19752605	19753505	379	900	+	220.32243932806782	77.6940408670655
chr22	19754505	19755025	380	520	+	117.84688615222231	41.13213928256408
chr22	19760045	19760965	381	920	+	443.20676748553177	196.52022101669507
chr22	19761445	19762265	382	820	+	648.1578738372227	315.34640116632465
chr22	19763705	19764705	383	1000	+	914.594312094421	255.9333110915099
chr22	19767025	19767525	384	500	+	169.08466274014506	13.710713094188028
chr22	19767805	19768305	385	500	+	2034.139730540533	479.874958296581
chr22	19768525	19769025	386	500	+	69.17099839369571	22.85118849031338
chr22	19770025	19770525	387	500	+	79.41855371128025	36.56190158450141
chr22	19793865	19794365	388	500	+	345.85499196847854	45.70237698062676
chr22	19802045	19802545	389	500	+	69.17099839369571	77.6940408670655
chr22	19802825	19803325	390	500	+	1475.6479657321752	137.10713094188029
chr22	19815065	19815605	391	540	+	407.3403238739858	246.7928356953845
chr22	19816105	19816625	392	520	+	94.78988668765707	27.421426188376056
chr22	19830405	19830905	393	500	+	51.237776587922745	50.27261467868944
chr22	19834005	19834525	394	520	+	89.6661090288648	54.84285237675211
chr22	19835365	19836225	395	860	+	94.78988668765707	68.55356547094014
chr22	19836305	19836805	396	500	+	97.35177551705321	63.98332777287747
chr22	19841485	19842712	397	1227	+	3181.8659261100024	2001.7641117514524
chr22	19843205	19843705	398	500	+	796.7474259421987	1179.1213261001706
chr22	19844225	19844725	399	500	+	74.29477605248798	63.98332777287747
chr22	19852105	19853065	400	960	+	253.6269941102176	31.991663886438737
chr22	19863205	19863785	401	580	+	61.485331905507294	13.710713094188028
chr22	19868625	19869125	402	500	+	76.85666488188411	13.710713094188028
chr22	19874365	19874905	403	540	+	122.97066381101459	36.56190158450141
chr22	19878425	19878945	404	520	+	71.73288722309184	95.9749916593162
chr22	19878985	19879505	405	520	+	1257.8874152335034	127.96665554575495
chr22	19879585	19880125	406	540	+	322.7979925039133	73.12380316900283
chr22	19880565	19881065	407	500	+	51.237776587922745	27.421426188376056
chr22	19884505	19885005	408	500	+	81.98044254067638	31.991663886438737
chr22	19893365	19893865	409	500	+	76.85666488188411	59.41309007481479
chr22	19897385	19897885	410	500	+	537.9966541731889	297.065450374074
chr22	19899985	19900485	411	500	+	71.73288722309184	18.280950792250707
chr22	19901585	19902085	412	500	+	61.485331905507294	68.55356547094014
chr22	19911485	19912025	413	540	+	140.90388561678753	54.84285237675211
chr22	19915805	19916745	414	940	+	140.90388561678753	86.83451626319085
chr22	19918525	19919025	415	500	+	61.485331905507294	27.421426188376056
chr22	19919985	19920485	416	500	+	79.41855371128025	50.27261467868944
chr22	19927645	19929025	417	1380	+	438.0829898267395	2042.8962510340164
chr22	19929105	19929765	418	660	+	228.0081058162562	1069.4356213466663
chr22	19929785	19931545	419	1760	+	737.8239828660876	3985.2472727106533
chr22	19932165	19933105	420	940	+	204.95110635169098	86.83451626319085
chr22	19935185	19935705	421	520	+	1877.8645119473686	667.2547039171508
chr22	19938209	19938709	422	500	+	20.495110635169095	59.41309007481479
chr22	19941105	19941625	423	520	+	99.91366434644934	41.13213928256408
chr22	19946685	19947185	424	500	+	2044.3872858581176	178.23927022444437
chr22	19947385	19947885	425	500	+	79.41855371128025	95.9749916593162
chr22	19949725	19950265	426	540	+	174.20844039893734	50.27261467868944
chr22	19953445	19953965	427	520	+	230.56999464565234	86.83451626319085
chr22	19957965	19958465	428	500	+	258.7507717690098	68.55356547094014
chr22	19961825	19962385	429	560	+	327.9217701627055	91.40475396125352
chr22	19962405	19963305	430	900	+	555.9298759789618	351.9083027508261
chr22	19971745	19972245	431	500	+	117.84688615222231	118.82618014962958
chr22	19973745	19974245	432	500	+	115.28499732282617	77.6940408670655
chr22	19974465	19975725	433	1260	+	363.78821377425146	210.23093411088308
chr22	19976305	19976805	434	500	+	143.46577444618367	91.40475396125352
chr22	19977165	19977685	435	520	+	81.98044254067638	73.12380316900283
chr22	19993165	19993685	436	520	+	66.60910956429957	13.710713094188028
chr22	19994925	19995425	437	500	+	184.4559957165219	86.83451626319085
chr22	19997105	19997605	438	500	+	202.38921752229484	196.52022101669507
chr22	19997945	19998465	439	520	+	197.26543986350256	191.9499833186324
chr22	19999145	19999645	440	500	+	238.25566113384076	91.40475396125352
chr22	20000845	20001385	441	540	+	128.09444146980684	100.54522935737889
chr22	20002825	20003345	442	520	+	133.21821912859915	100.54522935737889
chr22	20003645	20004705	443	1060	+	1398.791300850291	246.7928356953845
chr22	20008245	20008841	444	596	+	1047.8125312230202	731.2380316900282
chr22	20008885	20009405	445	520	+	453.45432280311627	1361.9308340226773
chr22	20010365	20010865	446	500	+	120.40877498161845	237.65236029925916
chr22	20011725	20013325	447	1600	+	2482.470275684857	927.7582527067233
chr22	20013705	20014205	448	500	+	94.78988668765707	73.12380316900283
chr22	20014465	20014965	449	500	+	76.85666488188411	100.54522935737889
chr22	20015405	20015945	450	540	+	56.361554246715016	27.421426188376056
chr22	20022765	20023265	451	500	+	102.47555317584549	36.56190158450141
chr22	20035705	20036205	452	500	+	69.17099839369571	18.280950792250707
chr22	20046005	20046925	453	920	+	1777.9508476009194	1010.0225312718513
chr22	20047125	20047625	454	500	+	366.3501026036476	164.52855713025633
chr22	20047725	20048225	455	500	+	69.17099839369571	86.83451626319085
chr22	20054305	20054825	456	520	+	107.59933083463775	73.12380316900283
chr22	20058905	20059805	457	900	+	1667.7896279368852	466.164245202393
chr22	20064105	20064665	458	560	+	835.1757583831408	159.95831943219366
chr22	20067285	20068305	459	1020	+	2346.6901677268615	1083.1463344408542
chr22	20068405	20069365	460	960	+	471.38754460888924	2298.8295621255265
chr22	20070585	20071485	461	900	+	151.15144093437212	493.585671390769
chr22	20072065	20073045	462	980	+	648.1578738372227	1064.8653836486035
chr22	20097665	20099325	463	1660	+	532.8728765143966	191.9499833186324
chr22	20099365	20099865	464	500	+	92.22799785826095	86.83451626319085
chr22	20103405	20103925	465	520	+	92.22799785826095	347.3380650527634
chr22	20104565	20105196	466	631	+	3186.9897037687947	489.0154336927064
chr22	20105305	20105965	467	660	+	225.44621698686007	1480.757014172307
chr22	20106085	20106585	468	500	+	212.63677283987937	534.7178106733331
chr22	20115325	20115845	469	520	+	120.40877498161845	73.12380316900283
chr22	20116185	20117185	470	1000	+	537.9966541731889	77.6940408670655
chr22	20118485	20118985	471	500	+	268.99832708659443	45.70237698062676
chr22	20119113	20119613	472	500	+	15.371332976376824	18.280950792250707
chr22	20119885	20120465	473	580	+	71.73288722309184	59.41309007481479
chr22	20125805	20126305	474	500	+	58.923443076111155	41.13213928256408
chr22	20137181	20137681	475	500	+	12.809444146980686	4.570237698062677
chr22	20138685	20139385	476	700	+	64.04722073490342	13.710713094188028
chr22	20140345	20141105	477	760	+	51.237776587922745	27.421426188376056
chr22	20141465	20141985	478	520	+	69.17099839369571	18.280950792250707
chr22	20144425	20144965	479	540	+	266.4364382571983	27.421426188376056
chr22	20162265	20162805	480	540	+	46.113998929130474	18.280950792250707
chr22	20174005	20174505	481	500	+	97.35177551705321	18.280950792250707
chr22	20187625	20188245	482	620	+	97.35177551705321	63.98332777287747
chr22	20191185	20191785	483	600	+	87.10422019946867	18.280950792250707
chr22	20192191	20192691	484	500	+	15.371332976376824	9.140475396125353
chr22	20193604	20194145	485	541	+	878.7278684828751	685.5356547094015
chr22	20194305	20194865	486	560	+	222.88432815746395	411.3213928256409
chr22	20195125	20195625	487	500	+	35.86644361154592	77.6940408670655
chr22	20199465	20199965	488	500	+	276.68399357478285	22.85118849031338
chr22	20203265	20203765	489	500	+	43.552110099734335	31.991663886438737
chr22	20207205	20207725	490	520	+	99.91366434644934	50.27261467868944
chr22	20222845	20223805	491	960	+	187.01788454591804	82.26427856512817
chr22	20225985	20226985	492	1000	+	279.24588240417893	22.85118849031338
chr22	20227845	20228405	493	560	+	79.41855371128025	13.710713094188028
chr22	20230985	20231985	494	1000	+	197.26543986350256	13.710713094188028
chr22	20232825	20233385	495	560	+	61.485331905507294	4.570237698062677
chr22	20234545	20235085	496	540	+	371.47388026243993	18.280950792250707
chr22	20241865	20242405	497	540	+	125.53255264041073	31.991663886438737
chr22	20244625	20245145	498	520	+	64.04722073490342	41.13213928256408
chr22	20246045	20246605	499	560	+	53.79966541731888	27.421426188376056
chr22	20254825	20255325	500	500	+	56.361554246715016	9.140475396125353
chr22	20255566	20256205	501	639	+	161.39899625195665	31.991663886438737
chr22	20257665	20258165	502	500	+	43.552110099734335	4.570237698062677
chr22	20267165	20267665	503	500	+	156.27521859316437	9.140475396125353
chr22	20273165	20273725	504	560	+	146.0276632755798	9.140475396125353
chr22	20279785	20280365	505	580	+	76.85666488188411	13.710713094188028
chr22	20283865	20284365	506	500	+	43.552110099734335	18.280950792250707
chr22	20286365	20287365	507	1000	+	1444.9052997794213	50.27261467868944
chr22	20305045	20306065	508	1020	+	138.34199678739142	27.421426188376056
chr22	20306565	20307878	509	1313	+	1770.2651811127307	548.4285237675211
chr22	20308065	20308565	510	500	+	102.47555317584549	228.51188490313382
chr22	20309325	20309865	511	540	+	71.73288722309184	13.710713094188028
chr22	20310205	20310705	512	500	+	69.17099839369571	63.98332777287747
chr22	20310945	20311445	513	500	+	61.485331905507294	18.280950792250707
chr22	20315925	20316485	514	560	+	58.923443076111155	0.0
chr22	20318625	20319125	515	500	+	20.495110635169095	0.0
chr22	20328269	20328769	516	500	+	5.123777658792274	0.0
chr22	20336743	20337243	517	500	+	0.0	0.0
chr22	20376985	20377918	518	933	+	17.93322180577296	4.570237698062677
chr22	20378285	20379265	519	980	+	456.0162116325124	0.0
chr22	20398445	20398945	520	500	+	0.0	0.0
chr22	20401345	20401845	521	500	+	15.371332976376824	0.0
chr22	20423505	20424005	522	500	+	40.99022127033819	13.710713094188028
chr22	20461536	20462036	523	500	+	5.123777658792274	4.570237698062677
chr22	20656578	20657078	524	500	+	0.0	0.0
chr22	20727665	20728165	525	500	+	53.79966541731888	22.85118849031338
chr22	20745385	20745885	526	500	+	46.113998929130474	68.55356547094014
chr22	20748145	20749145	527	1000	+	2044.3872858581176	1060.295145950541
chr22	20750125	20751045	528	920	+	125.53255264041073	82.26427856512817
chr22	20764525	20765025	529	500	+	56.361554246715016	68.55356547094014
chr22	20766705	20767265	530	560	+	361.2263249448553	118.82618014962958
chr22	20767725	20768225	531	500	+	40.99022127033819	22.85118849031338
chr22	20768445	20768945	532	500	+	69.17099839369571	36.56190158450141
chr22	20772385	20772885	533	500	+	379.1595467506283	100.54522935737889
chr22	20773325	20773825	534	500	+	51.237776587922745	59.41309007481479
chr22	20775645	20776145	535	500	+	38.42833244094206	59.41309007481479
chr22	20783405	20783925	536	520	+	402.21654621519355	86.83451626319085
chr22	20791896	20792396	537	500	+	15.371332976376824	0.0
chr22	20810465	20810985	538	520	+	604.6057637374885	82.26427856512817
chr22	20820885	20821385	539	500	+	30.742665952753647	18.280950792250707
chr22	20823445	20823985	540	540	+	133.21821912859915	73.12380316900283
chr22	20827225	20827725	541	500	+	43.552110099734335	31.991663886438737
chr22	20829865	20830385	542	520	+	161.39899625195665	9.140475396125353
chr22	20831905	20832405	543	500	+	84.54233137007253	22.85118849031338
chr22	20833825	20834365	544	540	+	135.78010795799528	54.84285237675211
chr22	20848845	20849825	545	980	+	181.89410688712573	342.7678273547007
chr22	20849920	20850485	546	565	+	1142.602417910677	900.3368265183472
chr22	20850645	20851145	547	500	+	553.3679871495657	662.684466219088
chr22	20858565	20859085	548	520	+	66.60910956429957	22.85118849031338
chr22	20861565	20862585	549	1020	+	1480.7717433909675	2449.6474061615945
chr22	20862925	20863505	550	580	+	110.16121966403391	813.5023102551563
chr22	20863605	20864105	551	500	+	625.1008743726575	502.7261467868944
chr22	20864585	20865085	552	500	+	56.361554246715016	109.68570475350423
chr22	20865325	20867045	553	1720	+	491.88265524405836	265.07378648763523
chr22	20877345	20877865	554	520	+	1342.429746603576	301.6356880721366
chr22	20878225	20878745	555	520	+	125.53255264041073	191.9499833186324
chr22	20880765	20881725	556	960	+	330.48365899210165	178.23927022444437
chr22	20899965	20900765	557	800	+	878.7278684828751	735.8082693880908
chr22	20903385	20904185	558	800	+	204.95110635169098	178.23927022444437
chr22	20911505	20912025	559	520	+	689.148095107561	310.776163468262
chr22	20918485	20919005	560	520	+	630.2246520314498	86.83451626319085
chr22	20925705	20926225	561	520	+	107.59933083463775	82.26427856512817
chr22	20931705	20932225	562	520	+	84.54233137007253	73.12380316900283
chr22	20935765	20936265	563	500	+	33.304554782149786	22.85118849031338
chr22	20937825	20938325	564	500	+	35.86644361154592	59.41309007481479
chr22	20942765	20943265	565	500	+	79.41855371128025	59.41309007481479
chr22	20946105	20946645	566	540	+	148.58955210497595	27.421426188376056
chr22	20955125	20955625	567	500	+	33.304554782149786	18.280950792250707
chr22	20959045	20959545	568	500	+	120.40877498161845	9.140475396125353
chr22	20960465	20960965	569	500	+	256.1888829396137	41.13213928256408
chr22	20961505	20962005	570	500	+	53.79966541731888	50.27261467868944
chr22	20969205	20969765	571	560	+	210.07488401048326	36.56190158450141
chr22	20969805	20970305	572	500	+	58.923443076111155	68.55356547094014
chr22	20976665	20977165	573	500	+	56.361554246715016	27.421426188376056
chr22	20996605	20997545	574	940	+	107.59933083463775	50.27261467868944
chr22	20998205	20998985	575	780	+	51.237776587922745	18.280950792250707
chr22	21002525	21003025	576	500	+	51.237776587922745	27.421426188376056
chr22	21003525	21004025	577	500	+	35.86644361154592	9.140475396125353
chr22	21005865	21006385	578	520	+	61.485331905507294	13.710713094188028
chr22	21025525	21026165	579	640	+	61.485331905507294	18.280950792250707
chr22	21027505	21028305	580	800	+	97.35177551705321	13.710713094188028
chr22	21042325	21043165	581	840	+	163.96088508135276	18.280950792250707
chr22	21043592	21044092	582	500	+	2.561888829396137	0.0
chr22	21051405	21052205	583	800	+	381.72143558002443	59.41309007481479
chr22	21055151	21055651	584	500	+	10.247555317584547	4.570237698062677
chr22	21056285	21058065	585	1780	+	2636.1836054486253	141.67736863994298
chr22	21058645	21059265	586	620	+	51.237776587922745	9.140475396125353
chr22	21076005	21076505	587	500	+	56.361554246715016	36.56190158450141
chr22	21094685	21095205	588	520	+	76.85666488188411	0.0
chr22	21095985	21096525	589	540	+	102.47555317584549	31.991663886438737
chr22	21104765	21105285	590	520	+	117.84688615222231	127.96665554575495
chr22	21112925	21113445	591	520	+	56.361554246715016	41.13213928256408
chr22	21123245	21123745	592	500	+	681.4624286193725	63.98332777287747
chr22	21128132	21128632	593	500	+	33.304554782149786	27.421426188376056
chr22	21130885	21131625	594	740	+	432.95921216794716	196.52022101669507
chr22	21131985	21132485	595	500	+	2669.488160230775	397.6106797314528
chr22	21135905	21136405	596	500	+	161.39899625195665	114.25594245156691
chr22	21138485	21139005	597	520	+	653.281651496015	45.70237698062676
chr22	21158165	21158705	598	540	+	89.6661090288648	63.98332777287747
chr22	21160145	21160665	599	520	+	158.8371074225605	105.11546705544154
chr22	21161645	21162425	600	780	+	302.30288186874424	443.31305671207963
chr22	21194505	21195005	601	500	+	87.10422019946867	54.84285237675211
chr22	21195085	21195605	602	520	+	299.7409930393481	73.12380316900283
chr22	21198205	21198745	603	540	+	105.03744200524163	45.70237698062676
chr22	21199265	21199765	604	500	+	97.35177551705321	13.710713094188028
chr22	21206305	21206805	605	500	+	204.95110635169098	41.13213928256408
chr22	21207445	21207985	606	540	+	425.27354567975874	146.24760633800565
chr22	21208645	21209165	607	520	+	125.53255264041073	54.84285237675211
chr22	21211505	21212025	608	520	+	860.794646677102	201.09045871475777
chr22	21212105	21214405	609	2300	+	3717.300691453795	1924.0700708843867
chr22	21217545	21218325	610	780	+	238.25566113384076	228.51188490313382
chr22	21220045	21220585	611	540	+	294.61721538055576	379.3297289392021
chr22	21221625	21222125	612	500	+	4660.075780671574	1151.6998999117943
chr22	21231165	21231665	613	500	+	84.54233137007253	54.84285237675211
chr22	21239225	21239725	614	500	+	56.361554246715016	132.53689324381762
chr22	21239745	21240505	615	760	+	2280.0810581625624	1000.8820558757262
chr22	21254325	21254825	616	500	+	53.79966541731888	9.140475396125353
chr22	21258865	21259425	617	560	+	110.16121966403391	73.12380316900283
chr22	21271005	21271963	618	958	+	6632.730179306599	2458.7878815577196
chr22	21272085	21272865	619	780	+	230.56999464565234	1745.8308006599423
chr22	21273005	21273505	620	500	+	225.44621698686007	150.8178440360683
chr22	21274025	21275165	621	1140	+	345.85499196847854	443.31305671207963
chr22	21275605	21276165	622	560	+	158.8371074225605	228.51188490313382
chr22	21276545	21277085	623	540	+	156.27521859316437	86.83451626319085
chr22	21286525	21287045	624	520	+	146.0276632755798	18.280950792250707
chr22	21291605	21292125	625	520	+	315.1123260157249	178.23927022444437
chr22	21296005	21296545	626	540	+	115.28499732282617	22.85118849031338
chr22	21299525	21300025	627	500	+	92.22799785826095	41.13213928256408
chr22	21304765	21305285	628	520	+	89.6661090288648	82.26427856512817
chr22	21307765	21308685	629	920	+	248.50321645142532	507.29638448495706
chr22	21309745	21310265	630	520	+	166.52277391074892	36.56190158450141
chr22	21310285	21311105	631	820	+	179.3322180577296	86.83451626319085
chr22	21311129	21311629	632	500	+	25.618888293961373	4.570237698062677
chr22	21315665	21316605	633	940	+	194.70355103410643	77.6940408670655
chr22	21319167	21319667	634	500	+	5.123777658792274	0.0
chr22	21326645	21327145	635	500	+	43.552110099734335	18.280950792250707
chr22	21334725	21335225	636	500	+	115.28499732282617	169.09879482831903
chr22	21335985	21336807	637	822	+	1283.5063035274648	2134.3010049952695
chr22	21336865	21337365	638	500	+	122.97066381101459	466.164245202393
chr22	21351805	21352385	639	580	+	107.59933083463775	82.26427856512817
chr22	21352645	21353605	640	960	+	297.1791042099519	237.65236029925916
chr22	21354945	21355565	641	620	+	189.57977337531415	703.8166055016522
chr22	21355865	21356665	642	800	+	4475.619784955052	2477.0688323499703
chr22	21356765	21357265	643	500	+	220.32243932806782	630.6928023326493
chr22	21358065	21358625	644	560	+	146.0276632755798	132.53689324381762
chr22	21368326	21368885	645	559	+	2277.519169333166	274.21426188376057
chr22	21368905	21369691	646	786	+	1788.198402918504	708.3868431997148
chr22	21375045	21375565	647	520	+	110.16121966403391	18.280950792250707
chr22	21386597	21387385	648	788	+	40.99022127033819	36.56190158450141
chr22	21392005	21392525	649	520	+	545.6823206613773	86.83451626319085
chr22	21392685	21393205	650	520	+	153.71332976376823	31.991663886438737
chr22	21394405	21394965	651	560	+	163.96088508135276	73.12380316900283
chr22	21398288	21398788	652	500	+	20.495110635169095	18.280950792250707
chr22	21399345	21400498	653	1153	+	819.8044254067639	105.11546705544154
chr22	21406005	21406505	654	500	+	56.361554246715016	27.421426188376056
chr22	21407285	21407805	655	520	+	56.361554246715016	41.13213928256408
chr22	21410065	21410585	656	520	+	292.0553265511596	41.13213928256408
chr22	21410965	21411465	657	500	+	945.3369780471746	127.96665554575495
chr22	21428365	21428865	658	500	+	48.675887758526606	27.421426188376056
chr22	21444145	21444645	659	500	+	48.675887758526606	31.991663886438737
chr22	21447885	21448385	660	500	+	1378.296190215122	63.98332777287747
chr22	21449185	21449685	661	500	+	40.99022127033819	18.280950792250707
chr22	21452285	21452785	662	500	+	197.26543986350256	22.85118849031338
chr22	21455425	21455945	663	520	+	74.29477605248798	27.421426188376056
chr22	21456085	21456645	664	560	+	89.6661090288648	77.6940408670655
chr22	21457005	21457554	665	549	+	476.5113222676815	73.12380316900283
chr22	21462705	21463605	666	900	+	210.07488401048326	82.26427856512817
chr22	21483325	21483865	667	540	+	51.237776587922745	0.0
chr22	21520941	21521441	668	500	+	0.0	0.0
chr22	21560145	21560645	669	500	+	23.056999464565237	0.0
chr22	21636463	21636963	670	500	+	2.561888829396137	0.0
chr22	21680675	21681175	671	500	+	0.0	0.0
chr22	21756925	21757425	672	500	+	84.54233137007253	0.0
chr22	21771442	21771942	673	500	+	0.0	0.0
chr22	21771965	21772465	674	500	+	69.17099839369571	45.70237698062676
chr22	21802225	21802785	675	560	+	71.73288722309184	182.80950792250704
chr22	21803065	21803705	676	640	+	76.85666488188411	118.82618014962958
chr22	21806225	21806725	677	500	+	61.485331905507294	4.570237698062677
chr22	21811385	21811965	678	580	+	115.28499732282617	118.82618014962958
chr22	21821208	21821708	679	500	+	0.0	0.0
chr22	21822325	21823105	680	780	+	958.1464221941553	18.280950792250707
chr22	21845105	21845605	681	500	+	17.93322180577296	0.0
chr22	21865925	21866445	682	520	+	28.180777123357508	0.0
chr22	21871530	21872030	683	500	+	5.123777658792274	0.0
chr22	21898845	21899345	684	500	+	40.99022127033819	0.0
chr22	21899707	21900207	685	500	+	20.495110635169095	0.0
chr22	21909645	21910145	686	500	+	66.60910956429957	9.140475396125353
chr22	21910245	21910745	687	500	+	1216.8971939631651	260.5035487895725
chr22	21918325	21918965	688	640	+	97.35177551705321	91.40475396125352
chr22	21919825	21920325	689	500	+	69.17099839369571	36.56190158450141
chr22	21921585	21922185	690	600	+	650.7197626666189	712.9570808977775
chr22	21922365	21925145	691	2780	+	832.6138695537446	2755.8533319317935
chr22	21925325	21925865	692	540	+	312.55043718632874	68.55356547094014
chr22	21928645	21929185	693	540	+	281.80777123357507	127.96665554575495
chr22	21939385	21940085	694	700	+	117.84688615222231	187.37974562056974
chr22	21941705	21942205	695	500	+	107.59933083463775	164.52855713025633
chr22	21942285	21942785	696	500	+	2382.5566113384075	178.23927022444437
chr22	21948065	21948565	697	500	+	133.21821912859915	137.10713094188029
chr22	21958245	21958745	698	500	+	122.97066381101459	105.11546705544154
chr22	21958965	21959525	699	560	+	125.53255264041073	123.39641784769225
chr22	21960885	21961445	700	560	+	151.15144093437212	301.6356880721366
chr22	21961725	21962505	701	780	+	307.42665952753646	676.3951793132761
chr22	21962905	21963405	702	500	+	179.3322180577296	36.56190158450141
chr22	21974265	21974765	703	500	+	179.3322180577296	59.41309007481479
chr22	21978305	21979225	704	920	+	571.3012089553386	255.9333110915099
chr22	21979565	21980085	705	520	+	240.8175499632369	137.10713094188029
chr22	21980365	21981865	706	1500	+	530.3109876850004	452.45353210820497
chr22	21982685	21983405	707	720	+	202.38921752229484	1160.8403753079197
chr22	21983465	21983965	708	500	+	1352.6773019211605	1704.6986613773781
chr22	21984090	21984665	709	575	+	1634.4850731547356	918.6177773105978
chr22	21984785	21985585	710	800	+	271.56021591599057	205.66069641282044
chr22	21986725	21987685	711	960	+	3525.159029249085	438.7428190140169
chr22	21991725	21992225	712	500	+	112.72310849343003	18.280950792250707
chr22	21992765	21993265	713	500	+	210.07488401048326	82.26427856512817
chr22	21995665	21996791	714	1126	+	5162.205991233217	3112.3318723806824
chr22	21997265	21997765	715	500	+	660.9673179842033	539.2880483713958
chr22	21997785	21998505	716	720	+	148.58955210497595	292.4952126760113
chr22	22000925	22001425	717	500	+	714.7669834015222	159.95831943219366
chr22	22004565	22005965	718	1400	+	722.4526498897106	868.3451626319085
chr22	22006105	22006625	719	520	+	1385.98185670331	694.6761301055268
chr22	22010705	22012105	720	1400	+	2164.796060839736	982.6011050834754
chr22	22012285	22012785	721	500	+	112.72310849343003	54.84285237675211
chr22	22014305	22014825	722	520	+	197.26543986350256	132.53689324381762
chr22	22019125	22019945	723	820	+	181.89410688712573	306.2059257701993
chr22	22020022	22020825	724	803	+	2239.0908368922237	2664.44857797054
chr22	22021085	22021585	725	500	+	151.15144093437212	329.05711426051266
chr22	22041065	22041565	726	500	+	56.361554246715016	155.388081734131
chr22	22052765	22053305	727	540	+	112.72310849343003	50.27261467868944
chr22	22055005	22056285	728	1280	+	322.7979925039133	123.39641784769225
chr22	22058105	22058665	729	560	+	112.72310849343003	22.85118849031338
chr22	22061865	22062385	730	520	+	271.56021591599057	41.13213928256408
chr22	22067085	22067905	731	820	+	2121.2439507400018	214.80117180894578
chr22	22069005	22069565	732	560	+	107.59933083463775	91.40475396125352
chr22	22073225	22074025	733	800	+	148.58955210497595	68.55356547094014
chr22	22080865	22081385	734	520	+	230.56999464565234	45.70237698062676
chr22	22085085	22085585	735	500	+	87.10422019946867	22.85118849031338
chr22	22089145	22090585	736	1440	+	3048.647706981403	278.78449958182324
chr22	22097725	22098225	737	500	+	56.361554246715016	31.991663886438737
chr22	22098425	22098925	738	500	+	199.82732869289867	22.85118849031338
chr22	22106225	22106745	739	520	+	130.65633029920298	27.421426188376056
chr22	22107845	22108385	740	540	+	105.03744200524163	146.24760633800565
chr22	22108745	22109325	741	580	+	3271.5320351388673	717.5273185958401
chr22	22110025	22110525	742	500	+	932.5275339001939	589.5606630500853
chr22	22114865	22115405	743	540	+	133.21821912859915	91.40475396125352
chr22	22128985	22129485	744	500	+	125.53255264041073	22.85118849031338
chr22	22133205	22133725	745	520	+	666.0910956429957	242.22259799732186
chr22	22134245	22134745	746	500	+	89.6661090288648	31.991663886438737
chr22	22138885	22139425	747	540	+	514.9396547086235	571.2797122578346
chr22	22140125	22140625	748	500	+	58.923443076111155	27.421426188376056
chr22	22145945	22146445	749	500	+	1196.402083327996	210.23093411088308
chr22	22161805	22162305	750	500	+	53.79966541731888	45.70237698062676
chr22	22170225	22170725	751	500	+	84.54233137007253	109.68570475350423
chr22	22170865	22171365	752	500	+	1560.1902971022475	447.88329441014224
chr22	22173585	22174125	753	540	+	217.76055049867165	63.98332777287747
chr22	22177745	22178245	754	500	+	94.78988668765707	41.13213928256408
chr22	22178345	22178865	755	520	+	289.4934377217635	82.26427856512817
chr22	22179865	22180385	756	520	+	210.07488401048326	36.56190158450141
chr22	22180485	22181005	757	520	+	486.7588775852661	31.991663886438737
chr22	22181385	22182025	758	640	+	194.70355103410643	82.26427856512817
chr22	22182345	22182845	759	500	+	84.54233137007253	59.41309007481479
chr22	22186845	22187845	760	1000	+	427.8354345091549	173.6690325263817
chr22	22191425	22191945	761	520	+	240.8175499632369	63.98332777287747
chr22	22197525	22198025	762	500	+	117.84688615222231	100.54522935737889
chr22	22200545	22201045	763	500	+	233.13188347504848	54.84285237675211
chr22	22202305	22202805	764	500	+	76.85666488188411	9.140475396125353
chr22	22202845	22203345	765	500	+	92.22799785826095	59.41309007481479
chr22	22203865	22204685	766	820	+	176.77032922833345	105.11546705544154
chr22	22208725	22209245	767	520	+	138.34199678739142	54.84285237675211
chr22	22209885	22210545	768	660	+	138.34199678739142	105.11546705544154
chr22	22212605	22213105	769	500	+	135.78010795799528	73.12380316900283
chr22	22214745	22215265	770	520	+	148.58955210497595	82.26427856512817
chr22	22215705	22216265	771	560	+	176.77032922833345	159.95831943219366
chr22	22217085	22217585	772	500	+	386.8452132388167	77.6940408670655
chr22	22218745	22219245	773	500	+	69.17099839369571	13.710713094188028
chr22	22219365	22219865	774	500	+	207.51299518108712	73.12380316900283
chr22	22219945	22220445	775	500	+	115.28499732282617	118.82618014962958
chr22	22220485	22221645	776	1160	+	350.97876962727076	1448.7653502858684
chr22	22221720	22222685	777	965	+	2830.8871564827314	2440.5069307654694
chr22	22222765	22223745	778	980	+	274.1221047453867	996.3118181776633
chr22	22224185	22224705	779	520	+	263.87454942780215	86.83451626319085
chr22	22225365	22226145	780	780	+	220.32243932806782	59.41309007481479
chr22	22226625	22227125	781	500	+	94.78988668765707	95.9749916593162
chr22	22230645	22231485	782	840	+	325.35988133330943	141.67736863994298
chr22	22235865	22236425	783	560	+	102.47555317584549	82.26427856512817
chr22	22236905	22237645	784	740	+	317.674214845121	31.991663886438737
chr22	22249225	22249725	785	500	+	66.60910956429957	22.85118849031338
chr22	22264545	22265085	786	540	+	253.6269941102176	18.280950792250707
chr22	22265405	22265905	787	500	+	158.8371074225605	36.56190158450141
chr22	22270985	22271545	788	560	+	89.6661090288648	4.570237698062677
chr22	22290625	22291145	789	520	+	163.96088508135276	95.9749916593162
chr22	22292325	22293305	790	980	+	2141.739061375171	2330.821226011965
chr22	22293665	22294185	791	520	+	92.22799785826095	205.66069641282044
chr22	22300885	22301825	792	940	+	179.3322180577296	772.3701709725923
chr22	22301945	22302445	793	500	+	1503.8287428555325	717.5273185958401
chr22	22302805	22303325	794	520	+	115.28499732282617	246.7928356953845
chr22	22306265	22306825	795	560	+	120.40877498161845	219.37140950700845
chr22	22307000	22307605	796	605	+	660.9673179842033	242.22259799732186
chr22	22326585	22327085	797	500	+	110.16121966403391	50.27261467868944
chr22	22336165	22336865	798	700	+	169.08466274014506	539.2880483713958
chr22	22336985	22337505	799	520	+	701.9575392545415	347.3380650527634
chr22	22339205	22339725	800	520	+	499.5683217322468	159.95831943219366
chr22	22340805	22341325	801	520	+	115.28499732282617	18.280950792250707
chr22	22342205	22342745	802	540	+	176.77032922833345	109.68570475350423
chr22	22346185	22346725	803	540	+	84.54233137007253	86.83451626319085
chr22	22346885	22347405	804	520	+	225.44621698686007	45.70237698062676
chr22	22356265	22357545	805	1280	+	1224.5828604513536	223.94164720507112
chr22	22372325	22372845	806	520	+	66.60910956429957	45.70237698062676
chr22	22377265	22378425	807	1160	+	258.7507717690098	164.52855713025633
chr22	22384845	22385365	808	520	+	240.8175499632369	68.55356547094014
chr22	22387845	22388385	809	540	+	110.16121966403391	45.70237698062676
chr22	22392105	22392605	810	500	+	381.72143558002443	63.98332777287747
chr22	22396285	22396785	811	500	+	238.25566113384076	36.56190158450141
chr22	22398082	22398585	812	503	+	33.304554782149786	59.41309007481479
chr22	22403105	22403605	813	500	+	79.41855371128025	31.991663886438737
chr22	22413025	22413565	814	540	+	56.361554246715016	63.98332777287747
chr22	22414885	22415425	815	540	+	138.34199678739142	36.56190158450141
chr22	22417425	22417925	816	500	+	97.35177551705321	159.95831943219366
chr22	22422025	22422525	817	500	+	17.93322180577296	31.991663886438737
chr22	22424325	22425005	818	680	+	84.54233137007253	86.83451626319085
chr22	22440085	22440625	819	540	+	112.72310849343003	59.41309007481479
chr22	22454225	22455085	820	860	+	327.9217701627055	114.25594245156691
chr22	22457265	22457805	821	540	+	58.923443076111155	36.56190158450141
chr22	22461865	22462365	822	500	+	74.29477605248798	77.6940408670655
chr22	22463925	22464445	823	520	+	855.6708690183098	338.19758965663806
chr22	22464845	22466225	824	1380	+	1598.6186295431894	530.1475729752705
chr22	22467685	22468185	825	500	+	51.237776587922745	50.27261467868944
chr22	22468345	22468845	826	500	+	53.79966541731888	4.570237698062677
chr22	22472725	22473225	827	500	+	46.113998929130474	18.280950792250707
chr22	22475265	22475765	828	500	+	40.99022127033819	4.570237698062677
chr22	22476885	22477405	829	520	+	87.10422019946867	9.140475396125353
chr22	22495745	22496245	830	500	+	97.35177551705321	68.55356547094014
chr22	22496525	22497245	831	720	+	417.5878791915704	95.9749916593162
chr22	22497865	22498385	832	520	+	148.58955210497595	68.55356547094014
chr22	22511005	22511565	833	560	+	471.38754460888924	146.24760633800565
chr22	22512525	22513125	834	600	+	76.85666488188411	31.991663886438737
chr22	22516265	22516765	835	500	+	58.923443076111155	36.56190158450141
chr22	22522845	22523345	836	500	+	192.1416622047103	63.98332777287747
chr22	22533285	22533785	837	500	+	33.304554782149786	45.70237698062676
chr22	22549685	22550205	838	520	+	379.1595467506283	95.9749916593162
chr22	22555445	22555985	839	540	+	107.59933083463775	41.13213928256408
chr22	22556065	22556565	840	500	+	35.86644361154592	27.421426188376056
chr22	22560585	22561085	841	500	+	128.09444146980684	54.84285237675211
chr22	22562145	22562725	842	580	+	181.89410688712573	100.54522935737889
chr22	22564605	22565105	843	500	+	51.237776587922745	41.13213928256408
chr22	22573205	22573705	844	500	+	20.495110635169095	22.85118849031338
chr22	22589925	22590425	845	500	+	51.237776587922745	13.710713094188028
chr22	22592365	22592865	846	500	+	33.304554782149786	13.710713094188028
chr22	22598941	22599441	847	500	+	5.123777658792274	27.421426188376056
chr22	22609185	22609685	848	500	+	35.86644361154592	9.140475396125353
chr22	22610525	22611025	849	500	+	20.495110635169095	4.570237698062677
chr22	22617025	22617525	850	500	+	146.0276632755798	13.710713094188028
chr22	22652212	22652712	851	500	+	166.52277391074892	50.27261467868944
chr22	22673445	22673945	852	500	+	23.056999464565237	22.85118849031338
chr22	22676245	22676745	853	500	+	140.90388561678753	4.570237698062677
chr22	22697125	22697645	854	520	+	202.38921752229484	41.13213928256408
chr22	22711565	22712065	855	500	+	384.2833244094206	31.991663886438737
chr22	22715245	22715745	856	500	+	28.180777123357508	0.0
chr22	22723405	22724045	857	640	+	61.485331905507294	9.140475396125353
chr22	22734605	22735165	858	560	+	84.54233137007253	31.991663886438737
chr22	22763525	22764045	859	520	+	112.72310849343003	45.70237698062676
chr22	22776905	22777405	860	500	+	222.88432815746395	41.13213928256408
chr22	22785725	22786245	861	520	+	222.88432815746395	50.27261467868944
chr22	22804825	22805325	862	500	+	33.304554782149786	27.421426188376056
chr22	22814985	22815505	863	520	+	161.39899625195665	9.140475396125353
chr22	22817365	22817925	864	560	+	135.78010795799528	36.56190158450141
chr22	22818325	22818845	865	520	+	586.6725419317154	45.70237698062676
chr22	22823125	22823625	866	500	+	40.99022127033819	0.0
chr22	22829045	22829545	867	500	+	56.361554246715016	36.56190158450141
chr22	22832925	22833465	868	540	+	105.03744200524163	31.991663886438737
chr22	22834505	22835005	869	500	+	66.60910956429957	27.421426188376056
chr22	22835125	22835625	870	500	+	66.60910956429957	45.70237698062676
chr22	22839185	22839685	871	500	+	51.237776587922745	54.84285237675211
chr22	22861985	22862505	872	520	+	228.0081058162562	351.9083027508261
chr22	22862905	22863755	873	850	+	1585.809185396209	1096.8570475350423
chr22	22871065	22871605	874	540	+	92.22799785826095	27.421426188376056
chr22	22873845	22874365	875	520	+	1093.9265301521505	932.328490404786
chr22	22874374	22874945	876	571	+	2157.1103943515473	1051.1546705544156
chr22	22875025	22875525	877	500	+	368.9119914330438	475.3047205985183
chr22	22888765	22889705	878	940	+	179.3322180577296	223.94164720507112
chr22	22890045	22890545	879	500	+	279.24588240417893	123.39641784769225
chr22	22890965	22891465	880	500	+	79.41855371128025	118.82618014962958
chr22	22895045	22895565	881	520	+	194.70355103410643	155.388081734131
chr22	22896065	22896605	882	540	+	386.8452132388167	342.7678273547007
chr22	22896905	22897765	883	860	+	210.07488401048326	667.2547039171508
chr22	22899325	22899825	884	500	+	312.55043718632874	2774.1342827240446
chr22	22899925	22900425	885	500	+	1831.7505130182383	699.2463678035895
chr22	22900665	22901205	886	540	+	161.39899625195665	630.6928023326493
chr22	22901445	22902405	887	960	+	3530.282806907877	1549.3105796432471
chr22	22908385	22908885	888	500	+	25.618888293961373	59.41309007481479
chr22	22918705	22919245	889	540	+	228.0081058162562	68.55356547094014
chr22	22921445	22921965	890	520	+	133.21821912859915	63.98332777287747
chr22	22929325	22929825	891	500	+	307.42665952753646	59.41309007481479
chr22	22936485	22937005	892	520	+	322.7979925039133	68.55356547094014
chr22	22958485	22959045	893	560	+	125.53255264041073	68.55356547094014
chr22	22973725	22974245	894	520	+	48.675887758526606	4.570237698062677
chr22	22978725	22979245	895	520	+	243.37943879263304	0.0
chr22	22986762	22987262	896	500	+	0.0	0.0
chr22	22988531	22989031	897	500	+	7.685666488188412	0.0
chr22	22994005	22994505	898	500	+	89.6661090288648	4.570237698062677
chr22	22996345	22996845	899	500	+	71.73288722309184	9.140475396125353
chr22	23008905	23009445	900	540	+	130.65633029920298	31.991663886438737
chr22	23023805	23024305	901	500	+	189.57977337531415	31.991663886438737
chr22	23027385	23027905	902	520	+	169.08466274014506	18.280950792250707
chr22	23030025	23030545	903	520	+	412.4641015327781	31.991663886438737
chr22	23035145	23035665	904	520	+	192.1416622047103	50.27261467868944
chr22	23045045	23045545	905	500	+	38.42833244094206	45.70237698062676
chr22	23046025	23046525	906	500	+	69.17099839369571	31.991663886438737
chr22	23050765	23051265	907	500	+	40.99022127033819	22.85118849031338
chr22	23052105	23052625	908	520	+	117.84688615222231	18.280950792250707
chr22	23053105	23053625	909	520	+	225.44621698686007	86.83451626319085
chr22	23062565	23063245	910	680	+	540.558543002585	114.25594245156691
chr22	23064365	23064925	911	560	+	102.47555317584549	41.13213928256408
chr22	23078425	23079025	912	600	+	66.60910956429957	31.991663886438737
chr22	23088065	23088565	913	500	+	181.89410688712573	18.280950792250707
chr22	23090545	23091285	914	740	+	187.01788454591804	41.13213928256408
chr22	23094805	23095305	915	500	+	48.675887758526606	50.27261467868944
chr22	23095965	23096485	916	520	+	333.04554782149785	50.27261467868944
chr22	23112145	23112645	917	500	+	76.85666488188411	50.27261467868944
chr22	23112665	23113165	918	500	+	368.9119914330438	73.12380316900283
chr22	23130585	23131105	919	520	+	251.06510528082146	50.27261467868944
chr22	23144765	23145285	920	520	+	115.28499732282617	86.83451626319085
chr22	23152165	23152925	921	760	+	220.32243932806782	54.84285237675211
chr22	23172365	23172865	922	500	+	30.742665952753647	50.27261467868944
chr22	23178625	23179165	923	540	+	79.41855371128025	109.68570475350423
chr22	23180845	23181345	924	500	+	35.86644361154592	68.55356547094014
chr22	23189825	23190325	925	500	+	58.923443076111155	36.56190158450141
chr22	23190505	23191005	926	500	+	210.07488401048326	82.26427856512817
chr22	23197805	23198325	927	520	+	117.84688615222231	63.98332777287747
chr22	23219545	23220065	928	520	+	225.44621698686007	59.41309007481479
chr22	23226065	23226585	929	520	+	594.3582084199038	82.26427856512817
chr22	23229709	23230209	930	500	+	10.247555317584547	22.85118849031338
chr22	23265565	23266145	931	580	+	71.73288722309184	77.6940408670655
chr22	23267985	23268485	932	500	+	53.79966541731888	59.41309007481479
chr22	23270845	23271385	933	540	+	115.28499732282617	123.39641784769225
chr22	23284845	23285385	934	540	+	476.5113222676815	155.388081734131
chr22	23285745	23286245	935	500	+	61.485331905507294	54.84285237675211
chr22	23296785	23297305	936	520	+	87.10422019946867	36.56190158450141
chr22	23297985	23298485	937	500	+	361.2263249448553	82.26427856512817
chr22	23301305	23301805	938	500	+	666.0910956429957	54.84285237675211
chr22	23316885	23317385	939	500	+	43.552110099734335	68.55356547094014
chr22	23318305	23318805	940	500	+	51.237776587922745	59.41309007481479
chr22	23337565	23338065	941	500	+	33.304554782149786	9.140475396125353
chr22	23339245	23339745	942	500	+	66.60910956429957	0.0
chr22	23358525	23359045	943	520	+	115.28499732282617	31.991663886438737
chr22	23371965	23372465	944	500	+	56.361554246715016	50.27261467868944
chr22	23377285	23377785	945	500	+	289.4934377217635	91.40475396125352
chr22	23380105	23380605	946	500	+	53.79966541731888	31.991663886438737
chr22	23409845	23410345	947	500	+	74.29477605248798	77.6940408670655
chr22	23412085	23412789	948	704	+	745.509649354276	82.26427856512817
chr22	23426225	23426725	949	500	+	69.17099839369571	27.421426188376056
chr22	23428925	23430465	950	1540	+	1301.4395253332377	201.09045871475777
chr22	23430525	23431025	951	500	+	48.675887758526606	45.70237698062676
chr22	23442345	23442845	952	500	+	56.361554246715016	91.40475396125352
chr22	23449065	23449565	953	500	+	125.53255264041073	63.98332777287747
chr22	23451045	23451545	954	500	+	61.485331905507294	68.55356547094014
chr22	23453065	23453565	955	500	+	81.98044254067638	36.56190158450141
chr22	23461625	23462525	956	900	+	166.52277391074892	164.52855713025633
chr22	23470525	23471045	957	520	+	345.85499196847854	45.70237698062676
chr22	23480065	23480565	958	500	+	74.29477605248798	41.13213928256408
chr22	23483405	23483925	959	520	+	230.56999464565234	77.6940408670655
chr22	23483991	23484525	960	534	+	1783.0746252597116	86.83451626319085
chr22	23487205	23487762	961	557	+	1834.3124018476342	54.84285237675211
chr22	23489665	23490205	962	540	+	163.96088508135276	59.41309007481479
chr22	23508185	23508705	963	520	+	112.72310849343003	18.280950792250707
chr22	23516025	23516545	964	520	+	292.0553265511596	41.13213928256408
chr22	23518325	23518825	965	500	+	146.0276632755798	77.6940408670655
chr22	23519305	23519805	966	500	+	1032.4411982466434	269.6440241856979
chr22	23520565	23521065	967	500	+	361.2263249448553	95.9749916593162
chr22	23521465	23521965	968	500	+	330.48365899210165	191.9499833186324
chr22	23522125	23523525	969	1400	+	801.8712036009908	1188.261801496296
chr22	23523945	23524445	970	500	+	74.29477605248798	95.9749916593162
chr22	23524685	23525185	971	500	+	468.8256557794931	324.48687656245005
chr22	23525405	23525945	972	540	+	553.3679871495657	260.5035487895725
chr22	23528065	23528585	973	520	+	92.22799785826095	114.25594245156691
chr22	23529325	23529845	974	520	+	725.0145387191068	68.55356547094014
chr22	23534285	23534785	975	500	+	140.90388561678753	118.82618014962958
chr22	23539985	23540505	976	520	+	197.26543986350256	127.96665554575495
chr22	23555985	23556505	977	520	+	117.84688615222231	36.56190158450141
chr22	23557325	23557825	978	500	+	87.10422019946867	114.25594245156691
chr22	23560805	23561585	979	780	+	438.0829898267395	287.9249749779486
chr22	23561905	23563045	980	1140	+	1649.8564061311124	955.1796788950993
chr22	23564805	23565305	981	500	+	94.78988668765707	105.11546705544154
chr22	23565705	23566525	982	820	+	2754.0304916008477	882.0558757260966
chr22	23568445	23569425	983	980	+	238.25566113384076	214.80117180894578
chr22	23569465	23570005	984	540	+	130.65633029920298	155.388081734131
chr22	23579325	23579845	985	520	+	243.37943879263304	45.70237698062676
chr22	23582965	23583505	986	540	+	87.10422019946867	118.82618014962958
chr22	23584225	23585165	987	940	+	397.09276855640127	246.7928356953845
chr22	23585185	23585705	988	520	+	112.72310849343003	105.11546705544154
chr22	23590585	23591085	989	500	+	543.1204318319811	86.83451626319085
chr22	23592185	23592685	990	500	+	637.9103185196382	191.9499833186324
chr22	23592805	23593345	991	540	+	222.88432815746395	292.4952126760113
chr22	23593785	23594425	992	640	+	1204.0877498161847	731.2380316900282
chr22	23604703	23605203	993	500	+	5.123777658792274	22.85118849031338
chr22	23611725	23612225	994	500	+	48.675887758526606	50.27261467868944
chr22	23612365	23612905	995	540	+	256.1888829396137	146.24760633800565
chr22	23621785	23622425	996	640	+	79.41855371128025	132.53689324381762
chr22	23623905	23624405	997	500	+	486.7588775852661	105.11546705544154
chr22	23632005	23632905	998	900	+	179.3322180577296	159.95831943219366
chr22	23644805	23645305	999	500	+	38.42833244094206	13.710713094188028
chr22	23657725	23658245	1000	520	+	202.38921752229484	9.140475396125353
chr22	23718385	23718905	1001	520	+	51.237776587922745	18.280950792250707
chr22	23724063	23724563	1002	500	+	0.0	9.140475396125353
chr22	23727985	23728525	1003	540	+	81.98044254067638	0.0
chr22	23744549	23745285	1004	736	+	135.78010795799528	41.13213928256408
chr22	23773465	23773985	1005	520	+	115.28499732282617	63.98332777287747
chr22	23775285	23776000	1006	715	+	48.675887758526606	18.280950792250707
chr22	23799705	23800265	1007	560	+	43.552110099734335	0.0
chr22	23802765	23803285	1008	520	+	46.113998929130474	0.0
chr22	23820265	23820785	1009	520	+	48.675887758526606	9.140475396125353
chr22	23828917	23829417	1010	500	+	7.685666488188412	0.0
chr22	23863065	23863565	1011	500	+	33.304554782149786	54.84285237675211
chr22	23863885	23864425	1012	540	+	66.60910956429957	114.25594245156691
chr22	23875405	23875945	1013	540	+	66.60910956429957	95.9749916593162
chr22	23875965	23876485	1014	520	+	189.57977337531415	59.41309007481479
chr22	23878365	23878985	1015	620	+	256.1888829396137	0.0
chr22	23880205	23880705	1016	500	+	233.13188347504848	18.280950792250707
chr22	23881705	23882205	1017	500	+	125.53255264041073	4.570237698062677
chr22	23885045	23885545	1018	500	+	28.180777123357508	0.0
chr22	23922245	23922745	1019	500	+	2.561888829396137	0.0
chr22	23922845	23923345	1020	500	+	30.742665952753647	0.0
chr22	23923525	23924025	1021	500	+	28.180777123357508	4.570237698062677
chr22	23933265	23933765	1022	500	+	58.923443076111155	13.710713094188028
chr22	23963345	23963845	1023	500	+	23.056999464565237	0.0
chr22	23964745	23965245	1024	500	+	25.618888293961373	9.140475396125353
chr22	23969565	23970065	1025	500	+	43.552110099734335	4.570237698062677
chr22	23974258	23974758	1026	500	+	12.809444146980686	4.570237698062677
chr22	23976365	23976865	1027	500	+	138.34199678739142	31.991663886438737
chr22	24016385	24016885	1028	500	+	17.93322180577296	9.140475396125353
chr22	24026745	24027265	1029	520	+	117.84688615222231	63.98332777287747
chr22	24027285	24027785	1030	500	+	25.618888293961373	13.710713094188028
chr22	24032797	24033297	1031	500	+	2.561888829396137	4.570237698062677
chr22	24057265	24057785	1032	520	+	38.42833244094206	18.280950792250707
chr22	24057965	24058465	1033	500	+	35.86644361154592	59.41309007481479
chr22	24059305	24059860	1034	555	+	176.77032922833345	228.51188490313382
chr22	24091825	24092325	1035	500	+	79.41855371128025	22.85118849031338
chr22	24092545	24093565	1036	1020	+	153.71332976376823	265.07378648763523
chr22	24096380	24096880	1037	500	+	5.123777658792274	0.0
chr22	24104950	24105465	1038	515	+	28.180777123357508	9.140475396125353
chr22	24108765	24109305	1039	540	+	99.91366434644934	196.52022101669507
chr22	24109745	24110905	1040	1160	+	292.0553265511596	598.7011384462105
chr22	24113065	24113585	1041	520	+	97.35177551705321	31.991663886438737
chr22	24114425	24115255	1042	830	+	46.113998929130474	36.56190158450141
chr22	24128845	24129785	1043	940	+	284.3696600629712	539.2880483713958
chr22	24180949	24181645	1044	696	+	1091.3646413227546	137.10713094188029
chr22	24188585	24189225	1045	640	+	48.675887758526606	22.85118849031338
chr22	24191605	24192165	1046	560	+	43.552110099734335	9.140475396125353
chr22	24198639	24199139	1047	500	+	28.180777123357508	4.570237698062677
chr22	24199685	24200225	1048	540	+	612.2914302256768	100.54522935737889
chr22	24200325	24200825	1049	500	+	58.923443076111155	68.55356547094014
chr22	24200905	24201405	1050	500	+	30.742665952753647	9.140475396125353
chr22	24204205	24204705	1051	500	+	38.42833244094206	9.140475396125353
chr22	24230405	24231425	1052	1020	+	228.0081058162562	356.47854044888874
chr22	24236245	24237365	1053	1120	+	558.4917648083579	466.164245202393
chr22	24237465	24237985	1054	520	+	138.34199678739142	223.94164720507112
chr22	24239805	24240305	1055	500	+	28.180777123357508	31.991663886438737
chr22	24240665	24241367	1056	702	+	38.42833244094206	9.140475396125353
chr22	24243585	24244285	1057	700	+	66.60910956429957	54.84285237675211
chr22	24256045	24256565	1058	520	+	263.87454942780215	68.55356547094014
chr22	24298665	24299205	1059	540	+	56.361554246715016	4.570237698062677
chr22	24299350	24299850	1060	500	+	0.0	0.0
chr22	24308775	24309275	1061	500	+	2.561888829396137	0.0
chr22	24313185	24313685	1062	500	+	15.371332976376824	36.56190158450141
chr22	24316430	24316930	1063	500	+	0.0	0.0
chr22	24321968	24322468	1064	500	+	0.0	0.0
chr22	24335845	24336365	1065	520	+	81.98044254067638	41.13213928256408
chr22	24347008	24347508	1066	500	+	2.561888829396137	0.0
chr22	24352985	24353485	1067	500	+	35.86644361154592	0.0
chr22	24359565	24360285	1068	720	+	105.03744200524163	159.95831943219366
chr22	24361005	24361505	1069	500	+	66.60910956429957	13.710713094188028
chr22	24368565	24369125	1070	560	+	51.237776587922745	0.0
chr22	24371785	24372685	1071	900	+	153.71332976376823	306.2059257701993
chr22	24372745	24373366	1072	621	+	648.1578738372227	370.18925354307675
chr22	24384061	24384565	1073	504	+	361.2263249448553	237.65236029925916
chr22	24388045	24388545	1074	500	+	286.93154889236735	41.13213928256408
chr22	24401649	24402149	1075	500	+	0.0	0.0
chr22	24405485	24405985	1076	500	+	30.742665952753647	31.991663886438737
chr22	24406265	24406765	1077	500	+	30.742665952753647	45.70237698062676
chr22	24407465	24408014	1078	549	+	653.281651496015	91.40475396125352
chr22	24408645	24409385	1079	740	+	76.85666488188411	114.25594245156691
chr22	24429345	24429905	1080	560	+	40.99022127033819	0.0
chr22	24446385	24446885	1081	500	+	2.561888829396137	0.0
chr22	24486425	24487005	1082	580	+	58.923443076111155	68.55356547094014
chr22	24487705	24488205	1083	500	+	458.57810046190855	141.67736863994298
chr22	24542185	24542745	1084	560	+	35.86644361154592	27.421426188376056
chr22	24552785	24553345	1085	560	+	102.47555317584549	22.85118849031338
chr22	24571065	24571565	1086	500	+	30.742665952753647	4.570237698062677
chr22	24577193	24577693	1087	500	+	5.123777658792274	0.0
chr22	24591565	24592085	1088	520	+	94.78988668765707	4.570237698062677
chr22	24593925	24594445	1089	520	+	84.54233137007253	31.991663886438737
chr22	24602405	24603185	1090	780	+	161.39899625195665	22.85118849031338
chr22	24603845	24604405	1091	560	+	58.923443076111155	9.140475396125353
chr22	24640860	24641405	1092	545	+	30.742665952753647	9.140475396125353
chr22	24647338	24647838	1093	500	+	0.0	0.0
chr22	24655325	24655825	1094	500	+	79.41855371128025	9.140475396125353
chr22	24658305	24658805	1095	500	+	10.247555317584547	0.0
chr22	24666465	24667305	1096	840	+	330.48365899210165	315.34640116632465
chr22	24667665	24668165	1097	500	+	38.42833244094206	68.55356547094014
chr22	24670585	24671105	1098	520	+	38.42833244094206	0.0
chr22	24680625	24681125	1099	500	+	107.59933083463775	54.84285237675211
chr22	24685845	24686345	1100	500	+	102.47555317584549	82.26427856512817
chr22	24701125	24701685	1101	560	+	56.361554246715016	41.13213928256408
chr22	24721005	24721505	1102	500	+	46.113998929130474	4.570237698062677
chr22	24726465	24726965	1103	500	+	30.742665952753647	4.570237698062677
chr22	24802785	24803345	1104	560	+	51.237776587922745	18.280950792250707
chr22	24823279	24823779	1105	500	+	10.247555317584547	9.140475396125353
chr22	24841305	24842145	1106	840	+	163.96088508135276	109.68570475350423
chr22	24846565	24847065	1107	500	+	35.86644361154592	45.70237698062676
chr22	24851605	24852125	1108	520	+	138.34199678739142	18.280950792250707
chr22	24855725	24856285	1109	560	+	102.47555317584549	9.140475396125353
chr22	24856605	24857225	1110	620	+	53.79966541731888	63.98332777287747
chr22	24858885	24859385	1111	500	+	17.93322180577296	9.140475396125353
chr22	24861465	24861985	1112	520	+	79.41855371128025	36.56190158450141
chr22	24862845	24863385	1113	540	+	133.21821912859915	18.280950792250707
chr22	24878425	24878965	1114	540	+	48.675887758526606	4.570237698062677
chr22	24890792	24891500	1115	708	+	2.561888829396137	0.0
chr22	24899065	24899565	1116	500	+	66.60910956429957	9.140475396125353
chr22	24906125	24907105	1117	980	+	171.6465515695412	86.83451626319085
chr22	24907145	24907665	1118	520	+	143.46577444618367	27.421426188376056
chr22	24907985	24908505	1119	520	+	56.361554246715016	22.85118849031338
chr22	24910025	24910525	1120	500	+	48.675887758526606	9.140475396125353
chr22	24917625	24918165	1121	540	+	46.113998929130474	4.570237698062677
chr22	24921285	24921805	1122	520	+	122.97066381101459	13.710713094188028
chr22	24949905	24950405	1123	500	+	17.93322180577296	402.18091742951555
chr22	24951025	24952165	1124	1140	+	748.0715381836721	722.0975562939028
chr22	24974305	24974805	1125	500	+	46.113998929130474	22.85118849031338
chr22	24988785	24989365	1126	580	+	64.04722073490342	45.70237698062676
chr22	24995965	24996465	1127	500	+	10.247555317584547	9.140475396125353
chr22	24998873	24999445	1128	572	+	38.42833244094206	4.570237698062677
chr22	24999525	25000025	1129	500	+	46.113998929130474	54.84285237675211
chr22	25000065	25000565	1130	500	+	35.86644361154592	27.421426188376056
chr22	25003285	25003805	1131	520	+	69.17099839369571	36.56190158450141
chr22	25018485	25018985	1132	500	+	74.29477605248798	0.0
chr22	25019125	25019625	1133	500	+	5.123777658792274	0.0
chr22	25026665	25027185	1134	520	+	97.35177551705321	13.710713094188028
chr22	25028545	25029165	1135	620	+	35.86644361154592	0.0
chr22	25030925	25031425	1136	500	+	43.552110099734335	13.710713094188028
chr22	25047445	25047945	1137	500	+	20.495110635169095	0.0
chr22	25054864	25055364	1138	500	+	0.0	0.0
chr22	25059985	25060485	1139	500	+	10.247555317584547	0.0
chr22	25092005	25092505	1140	500	+	76.85666488188411	18.280950792250707
chr22	25101985	25102485	1141	500	+	30.742665952753647	13.710713094188028
chr22	25103105	25103605	1142	500	+	17.93322180577296	45.70237698062676
chr22	25123025	25123825	1143	800	+	361.2263249448553	219.37140950700845
chr22	25124805	25125305	1144	500	+	917.1562009238171	283.35473727988597
chr22	25126225	25126745	1145	520	+	51.237776587922745	86.83451626319085
chr22	25147445	25147965	1146	520	+	125.53255264041073	54.84285237675211
chr22	25149085	25149585	1147	500	+	33.304554782149786	4.570237698062677
chr22	25149965	25150465	1148	500	+	35.86644361154592	9.140475396125353
chr22	25154005	25154585	1149	580	+	84.54233137007253	9.140475396125353
chr22	25160217	25160717	1150	500	+	0.0	0.0
chr22	25164705	25165205	1151	500	+	35.86644361154592	9.140475396125353
chr22	25170437	25170937	1152	500	+	0.0	0.0
chr22	25198865	25199365	1153	500	+	46.113998929130474	0.0
chr22	25201865	25202437	1154	572	+	122.97066381101459	22.85118849031338
chr22	25279325	25279825	1155	500	+	38.42833244094206	9.140475396125353
chr22	25290365	25290885	1156	520	+	28.180777123357508	22.85118849031338
chr22	25335064	25335564	1157	500	+	5.123777658792274	9.140475396125353
chr22	25347985	25348825	1158	840	+	74.29477605248798	13.710713094188028
chr22	25423690	25424190	1159	500	+	5.123777658792274	0.0
chr22	25496845	25497365	1160	520	+	163.96088508135276	36.56190158450141
chr22	25506865	25507365	1161	500	+	20.495110635169095	4.570237698062677
chr22	25508409	25508909	1162	500	+	7.685666488188412	13.710713094188028
chr22	25544245	25544745	1163	500	+	38.42833244094206	0.0
chr22	25595566	25596066	1164	500	+	2.561888829396137	4.570237698062677
chr22	25598265	25598765	1165	500	+	30.742665952753647	0.0
chr22	25615361	25615861	1166	500	+	0.0	0.0
chr22	25631725	25632285	1167	560	+	53.79966541731888	18.280950792250707
chr22	25713973	25714473	1168	500	+	0.0	0.0
chr22	25758105	25758605	1169	500	+	28.180777123357508	4.570237698062677
chr22	25777294	25777794	1170	500	+	0.0	0.0
chr22	25794425	25794945	1171	520	+	66.60910956429957	13.710713094188028
chr22	25796945	25797445	1172	500	+	40.99022127033819	9.140475396125353
chr22	25799645	25800225	1173	580	+	71.73288722309184	141.67736863994298
chr22	25801105	25801605	1174	500	+	30.742665952753647	18.280950792250707
chr22	25802365	25802905	1175	540	+	46.113998929130474	27.421426188376056
chr22	25815145	25815885	1176	740	+	97.35177551705321	41.13213928256408
chr22	25843065	25844303	1177	1238	+	292.0553265511596	242.22259799732186
chr22	25844505	25845005	1178	500	+	51.237776587922745	109.68570475350423
chr22	25858405	25858925	1179	520	+	58.923443076111155	27.421426188376056
chr22	25884165	25884665	1180	500	+	58.923443076111155	4.570237698062677
chr22	25890585	25891085	1181	500	+	48.675887758526606	4.570237698062677
chr22	25941445	25941985	1182	540	+	66.60910956429957	22.85118849031338
chr22	25942625	25943165	1183	540	+	35.86644361154592	4.570237698062677
chr22	25959485	25959985	1184	500	+	38.42833244094206	13.710713094188028
chr22	25960345	25961110	1185	765	+	125.53255264041073	54.84285237675211
chr22	25961325	25961825	1186	500	+	35.86644361154592	27.421426188376056
chr22	25963085	25963625	1187	540	+	74.29477605248798	9.140475396125353
chr22	25998805	25999365	1188	560	+	58.923443076111155	0.0
chr22	26008985	26009485	1189	500	+	7.685666488188412	0.0
chr22	26023265	26023765	1190	500	+	5.123777658792274	9.140475396125353
chr22	26046665	26047225	1191	560	+	56.361554246715016	9.140475396125353
chr22	26062165	26062685	1192	520	+	71.73288722309184	4.570237698062677
chr22	26120005	26120505	1193	500	+	38.42833244094206	22.85118849031338
chr22	26121925	26122725	1194	800	+	81.98044254067638	173.6690325263817
chr22	26124005	26124505	1195	500	+	23.056999464565237	22.85118849031338
chr22	26136725	26137285	1196	560	+	40.99022127033819	63.98332777287747
chr22	26137685	26138360	1197	675	+	391.968990897609	776.940408670655
chr22	26138905	26139405	1198	500	+	30.742665952753647	274.21426188376057
chr22	26143205	26143825	1199	620	+	163.96088508135276	41.13213928256408
chr22	26144985	26145485	1200	500	+	33.304554782149786	50.27261467868944
chr22	26145745	26146285	1201	540	+	166.52277391074892	82.26427856512817
chr22	26146785	26147305	1202	520	+	87.10422019946867	54.84285237675211
chr22	26155725	26156225	1203	500	+	292.0553265511596	13.710713094188028
chr22	26158065	26158565	1204	500	+	169.08466274014506	77.6940408670655
chr22	26168745	26169245	1205	500	+	33.304554782149786	9.140475396125353
chr22	26212525	26213025	1206	500	+	48.675887758526606	22.85118849031338
chr22	26248865	26250005	1207	1140	+	107.59933083463775	201.09045871475777
chr22	26565189	26565689	1208	500	+	7.685666488188412	0.0
chr22	26635445	26635945	1209	500	+	23.056999464565237	4.570237698062677
chr22	26717565	26718065	1210	500	+	15.371332976376824	27.421426188376056
chr22	26752565	26753065	1211	500	+	115.28499732282617	9.140475396125353
chr22	26756345	26756845	1212	500	+	204.95110635169098	36.56190158450141
chr22	26760365	26760885	1213	520	+	122.97066381101459	13.710713094188028
chr22	26763505	26764045	1214	540	+	53.79966541731888	4.570237698062677
chr22	26773385	26773905	1215	520	+	51.237776587922745	4.570237698062677
chr22	26794525	26795065	1216	540	+	33.304554782149786	13.710713094188028
chr22	26797045	26798105	1217	1060	+	228.0081058162562	77.6940408670655
chr22	26799005	26799505	1218	500	+	48.675887758526606	59.41309007481479
chr22	26800765	26801325	1219	560	+	847.9852025301213	182.80950792250704
chr22	26805605	26806185	1220	580	+	38.42833244094206	31.991663886438737
chr22	26807165	26807665	1221	500	+	38.42833244094206	0.0
chr22	26824745	26825529	1222	784	+	69.17099839369571	36.56190158450141
chr22	26857045	26857585	1223	540	+	71.73288722309184	4.570237698062677
chr22	26858645	26859665	1224	1020	+	58.923443076111155	68.55356547094014
chr22	26870525	26871025	1225	500	+	28.180777123357508	4.570237698062677
chr22	26873225	26873745	1226	520	+	58.923443076111155	54.84285237675211
chr22	26875025	26876305	1227	1280	+	212.63677283987937	671.8249416152134
chr22	26877625	26878125	1228	500	+	28.180777123357508	118.82618014962958
chr22	26878145	26878645	1229	500	+	53.79966541731888	73.12380316900283
chr22	26879205	26880445	1230	1240	+	309.9885483569326	552.9987614655838
chr22	26881025	26881525	1231	500	+	30.742665952753647	91.40475396125352
chr22	26882305	26882805	1232	500	+	25.618888293961373	18.280950792250707
chr22	26889145	26890045	1233	900	+	550.8060983201696	1339.079645532364
chr22	26892385	26892885	1234	500	+	35.86644361154592	13.710713094188028
chr22	26896485	26897005	1235	520	+	417.5878791915704	41.13213928256408
chr22	26898845	26899345	1236	500	+	38.42833244094206	27.421426188376056
chr22	26908222	26908765	1237	543	+	307.42665952753646	260.5035487895725
chr22	26914225	26914725	1238	500	+	71.73288722309184	86.83451626319085
chr22	26915405	26915905	1239	500	+	30.742665952753647	54.84285237675211
chr22	26916645	26917145	1240	500	+	30.742665952753647	4.570237698062677
chr22	26950805	26951305	1241	500	+	12.809444146980686	50.27261467868944
chr22	26964205	26964725	1242	520	+	46.113998929130474	54.84285237675211
chr22	26969145	26969645	1243	500	+	243.37943879263304	59.41309007481479
chr22	26980945	26981445	1244	500	+	71.73288722309184	50.27261467868944
chr22	26982425	26982945	1245	520	+	228.0081058162562	91.40475396125352
chr22	26984145	26984665	1246	520	+	174.20844039893734	132.53689324381762
chr22	26985839	26986425	1247	586	+	92.22799785826095	95.9749916593162
chr22	26992845	26993365	1248	520	+	30.742665952753647	22.85118849031338
chr22	27002485	27002985	1249	500	+	23.056999464565237	31.991663886438737
chr22	27004045	27004565	1250	520	+	51.237776587922745	13.710713094188028
chr22	27013605	27014241	1251	636	+	156.27521859316437	287.9249749779486
chr22	27014385	27014885	1252	500	+	33.304554782149786	127.96665554575495
chr22	27017677	27018177	1253	500	+	12.809444146980686	27.421426188376056
chr22	27022805	27023305	1254	500	+	35.86644361154592	9.140475396125353
chr22	27024605	27025125	1255	520	+	99.91366434644934	50.27261467868944
chr22	27026105	27026705	1256	600	+	130.65633029920298	210.23093411088308
chr22	27028445	27028985	1257	540	+	684.0243174487687	315.34640116632465
chr22	27036525	27037085	1258	560	+	71.73288722309184	36.56190158450141
chr22	27037845	27038565	1259	720	+	163.96088508135276	370.18925354307675
chr22	27038785	27039725	1260	940	+	371.47388026243993	274.21426188376057
chr22	27041105	27041605	1261	500	+	425.27354567975874	91.40475396125352
chr22	27053195	27053695	1262	500	+	15.371332976376824	4.570237698062677
chr22	27054785	27055285	1263	500	+	371.47388026243993	68.55356547094014
chr22	27061385	27061885	1264	500	+	87.10422019946867	18.280950792250707
chr22	27064805	27065345	1265	540	+	64.04722073490342	18.280950792250707
chr22	27068425	27069205	1266	780	+	491.88265524405836	758.6594578784042
chr22	27074865	27075385	1267	520	+	102.47555317584549	9.140475396125353
chr22	27084225	27084765	1268	540	+	64.04722073490342	9.140475396125353
chr22	27103465	27103965	1269	500	+	30.742665952753647	9.140475396125353
chr22	27109905	27110405	1270	500	+	20.495110635169095	13.710713094188028
chr22	27173345	27173865	1271	520	+	43.552110099734335	4.570237698062677
chr22	27231805	27232325	1272	520	+	51.237776587922745	13.710713094188028
chr22	27299004	27299504	1273	500	+	0.0	0.0
chr22	27456230	27456730	1274	500	+	5.123777658792274	4.570237698062677
chr22	27530225	27530765	1275	540	+	69.17099839369571	45.70237698062676
chr22	27550585	27551145	1276	560	+	33.304554782149786	22.85118849031338
chr22	27583227	27583727	1277	500	+	2.561888829396137	0.0
chr22	27706361	27706861	1278	500	+	0.0	4.570237698062677
chr22	27710285	27710805	1279	520	+	181.89410688712573	50.27261467868944
chr22	27953485	27953985	1280	500	+	30.742665952753647	0.0
chr22	27990625	27991145	1281	520	+	74.29477605248798	22.85118849031338
chr22	28023345	28023845	1282	500	+	23.056999464565237	13.710713094188028
chr22	28028845	28029365	1283	520	+	58.923443076111155	9.140475396125353
chr22	28058585	28059105	1284	520	+	33.304554782149786	9.140475396125353
chr22	28065205	28065725	1285	520	+	133.21821912859915	201.09045871475777
chr22	28066565	28067065	1286	500	+	102.47555317584549	214.80117180894578
chr22	28067085	28067585	1287	500	+	35.86644361154592	415.89163052370355
chr22	28081405	28081905	1288	500	+	35.86644361154592	4.570237698062677
chr22	28114125	28114625	1289	500	+	271.56021591599057	210.23093411088308
chr22	28115545	28116045	1290	500	+	117.84688615222231	123.39641784769225
chr22	28122585	28123105	1291	520	+	456.0162116325124	420.46186822176617
chr22	28197236	28197736	1292	500	+	7.685666488188412	4.570237698062677
chr22	28225585	28226085	1293	500	+	48.675887758526606	22.85118849031338
chr22	28238505	28239005	1294	500	+	35.86644361154592	13.710713094188028
chr22	28242865	28243425	1295	560	+	187.01788454591804	68.55356547094014
chr22	28245345	28245865	1296	520	+	40.99022127033819	4.570237698062677
chr22	28276745	28277245	1297	500	+	69.17099839369571	4.570237698062677
chr22	28279485	28279985	1298	500	+	43.552110099734335	0.0
chr22	28307205	28307725	1299	520	+	56.361554246715016	4.570237698062677
chr22	28309105	28309625	1300	520	+	307.42665952753646	109.68570475350423
chr22	28314305	28315005	1301	700	+	87.10422019946867	164.52855713025633
chr22	28315044	28315625	1302	581	+	473.9494334382854	196.52022101669507
chr22	28315965	28316485	1303	520	+	33.304554782149786	219.37140950700845
chr22	28348045	28348565	1304	520	+	135.78010795799528	9.140475396125353
chr22	28361485	28362005	1305	520	+	33.304554782149786	4.570237698062677
chr22	28386665	28387345	1306	680	+	94.78988668765707	41.13213928256408
chr22	28405205	28405725	1307	520	+	58.923443076111155	9.140475396125353
chr22	28421185	28421685	1308	500	+	33.304554782149786	9.140475396125353
chr22	28423385	28423945	1309	560	+	40.99022127033819	27.421426188376056
chr22	28428825	28429365	1310	540	+	202.38921752229484	36.56190158450141
chr22	28430985	28431505	1311	520	+	304.8647706981403	27.421426188376056
chr22	28447645	28448165	1312	520	+	46.113998929130474	13.710713094188028
chr22	28471145	28471645	1313	500	+	69.17099839369571	9.140475396125353
chr22	28508645	28509165	1314	520	+	92.22799785826095	31.991663886438737
chr22	28637825	28638325	1315	500	+	210.07488401048326	95.9749916593162
chr22	28639305	28639905	1316	600	+	53.79966541731888	54.84285237675211
chr22	28640725	28641285	1317	560	+	51.237776587922745	50.27261467868944
chr22	28643545	28644065	1318	520	+	125.53255264041073	59.41309007481479
chr22	28693525	28694025	1319	500	+	48.675887758526606	4.570237698062677
chr22	28711945	28712485	1320	540	+	174.20844039893734	22.85118849031338
chr22	28747545	28748045	1321	500	+	28.180777123357508	0.0
chr22	28765765	28766325	1322	560	+	71.73288722309184	18.280950792250707
chr22	28769885	28770385	1323	500	+	38.42833244094206	0.0
chr22	28791925	28792465	1324	540	+	64.04722073490342	9.140475396125353
chr22	28805925	28806465	1325	540	+	40.99022127033819	4.570237698062677
chr22	28838145	28838665	1326	520	+	133.21821912859915	63.98332777287747
chr22	28839365	28839925	1327	560	+	43.552110099734335	9.140475396125353
chr22	28844605	28845125	1328	520	+	151.15144093437212	50.27261467868944
chr22	28940345	28940865	1329	520	+	51.237776587922745	27.421426188376056
chr22	28956305	28956805	1330	500	+	614.8533190550729	233.0821226011965
chr22	28957405	28957905	1331	500	+	48.675887758526606	95.9749916593162
chr22	28958425	28958925	1332	500	+	35.86644361154592	59.41309007481479
chr22	28970325	28970885	1333	560	+	48.675887758526606	4.570237698062677
chr22	28985065	28985605	1334	540	+	48.675887758526606	9.140475396125353
chr22	28990565	28991105	1335	540	+	143.46577444618367	4.570237698062677
chr22	28996465	28996985	1336	520	+	71.73288722309184	9.140475396125353
chr22	29004365	29004865	1337	500	+	33.304554782149786	18.280950792250707
chr22	29005865	29006385	1338	520	+	194.70355103410643	22.85118849031338
chr22	29016425	29016965	1339	540	+	56.361554246715016	22.85118849031338
chr22	29051685	29052585	1340	900	+	215.1986616692755	59.41309007481479
chr22	29066105	29066605	1341	500	+	23.056999464565237	13.710713094188028
chr22	29069985	29070485	1342	500	+	169.08466274014506	0.0
chr22	29075585	29076103	1343	518	+	48.675887758526606	27.421426188376056
chr22	29082525	29083025	1344	500	+	5.123777658792274	0.0
chr22	29136085	29136625	1345	540	+	69.17099839369571	95.9749916593162
chr22	29137572	29138825	1346	1253	+	1365.486746068141	191.9499833186324
chr22	29168385	29168911	1347	526	+	294.61721538055576	173.6690325263817
chr22	29169385	29169885	1348	500	+	35.86644361154592	123.39641784769225
chr22	29175745	29176285	1349	540	+	240.8175499632369	100.54522935737889
chr22	29195205	29195805	1350	600	+	69.17099839369571	552.9987614655838
chr22	29196310	29196885	1351	575	+	233.13188347504848	415.89163052370355
chr22	29198165	29198665	1352	500	+	230.56999464565234	164.52855713025633
chr22	29207685	29208185	1353	500	+	38.42833244094206	31.991663886438737
chr22	29218825	29219405	1354	580	+	61.485331905507294	13.710713094188028
chr22	29225285	29225785	1355	500	+	35.86644361154592	4.570237698062677
chr22	29251545	29252085	1356	540	+	79.41855371128025	4.570237698062677
chr22	29264305	29264825	1357	520	+	61.485331905507294	0.0
chr22	29269445	29269965	1358	520	+	38.42833244094206	9.140475396125353
chr22	29278445	29278985	1359	540	+	110.16121966403391	123.39641784769225
chr22	29279225	29279745	1360	520	+	138.34199678739142	4.570237698062677
chr22	29280665	29281165	1361	500	+	25.618888293961373	31.991663886438737
chr22	29281385	29282345	1362	960	+	74.29477605248798	13.710713094188028
chr22	29283085	29283605	1363	520	+	56.361554246715016	9.140475396125353
chr22	29288045	29288545	1364	500	+	43.552110099734335	18.280950792250707
chr22	29305245	29305745	1365	500	+	135.78010795799528	18.280950792250707
chr22	29313126	29313626	1366	500	+	12.809444146980686	13.710713094188028
chr22	29322925	29323425	1367	500	+	15.371332976376824	4.570237698062677
chr22	29323485	29324025	1368	540	+	61.485331905507294	41.13213928256408
chr22	29326305	29326805	1369	500	+	30.742665952753647	4.570237698062677
chr22	29358105	29358625	1370	520	+	64.04722073490342	22.85118849031338
chr22	29372505	29373045	1371	540	+	61.485331905507294	9.140475396125353
chr22	29374125	29374625	1372	500	+	40.99022127033819	0.0
chr22	29424425	29424925	1373	500	+	25.618888293961373	18.280950792250707
chr22	29425865	29426405	1374	540	+	99.91366434644934	41.13213928256408
chr22	29427214	29427765	1375	551	+	194.70355103410643	443.31305671207963
chr22	29436545	29437105	1376	560	+	130.65633029920298	13.710713094188028
chr22	29454945	29455445	1377	500	+	30.742665952753647	22.85118849031338
chr22	29457657	29458157	1378	500	+	10.247555317584547	4.570237698062677
chr22	29467025	29467525	1379	500	+	28.180777123357508	13.710713094188028
chr22	29467765	29468265	1380	500	+	25.618888293961373	13.710713094188028
chr22	29468525	29469315	1381	790	+	302.30288186874424	68.55356547094014
chr22	29474745	29475265	1382	520	+	69.17099839369571	164.52855713025633
chr22	29479805	29480445	1383	640	+	117.84688615222231	9.140475396125353
chr22	29485305	29485925	1384	620	+	30.742665952753647	22.85118849031338
chr22	29490905	29491405	1385	500	+	28.180777123357508	9.140475396125353
chr22	29492885	29493665	1386	780	+	489.3207664146622	287.9249749779486
chr22	29498985	29499485	1387	500	+	40.99022127033819	4.570237698062677
chr22	29501365	29501865	1388	500	+	20.495110635169095	27.421426188376056
chr22	29504145	29504645	1389	500	+	23.056999464565237	13.710713094188028
chr22	29505805	29506325	1390	520	+	294.61721538055576	196.52022101669507
chr22	29514065	29514625	1391	560	+	102.47555317584549	22.85118849031338
chr22	29521805	29522325	1392	520	+	40.99022127033819	9.140475396125353
chr22	29525245	29525765	1393	520	+	112.72310849343003	59.41309007481479
chr22	29548285	29548785	1394	500	+	161.39899625195665	484.4451959946437
chr22	29548845	29549345	1395	500	+	981.2034216587205	415.89163052370355
chr22	29550345	29550865	1396	520	+	128.09444146980684	36.56190158450141
chr22	29552445	29552945	1397	500	+	38.42833244094206	4.570237698062677
chr22	29553685	29554225	1398	540	+	71.73288722309184	59.41309007481479
chr22	29588385	29588905	1399	520	+	79.41855371128025	50.27261467868944
chr22	29591525	29592405	1400	880	+	671.214873301788	584.9904253520226
chr22	29593005	29593505	1401	500	+	79.41855371128025	63.98332777287747
chr22	29598145	29599105	1402	960	+	368.9119914330438	351.9083027508261
chr22	29599385	29599965	1403	580	+	38.42833244094206	18.280950792250707
chr22	29601650	29602150	1404	500	+	10.247555317584547	50.27261467868944
chr22	29635485	29635985	1405	500	+	10.247555317584547	0.0
chr22	29641425	29641945	1406	520	+	66.60910956429957	22.85118849031338
chr22	29662485	29662985	1407	500	+	28.180777123357508	283.35473727988597
chr22	29663725	29664247	1408	522	+	412.4641015327781	1064.8653836486035
chr22	29666325	29666865	1409	540	+	166.52277391074892	4.570237698062677
chr22	29697545	29698045	1410	500	+	33.304554782149786	9.140475396125353
chr22	29699525	29700045	1411	520	+	317.674214845121	54.84285237675211
chr22	29702025	29703725	1412	1700	+	430.397323338551	461.5940075043303
chr22	29705205	29705705	1413	500	+	23.056999464565237	31.991663886438737
chr22	29706865	29707405	1414	540	+	192.1416622047103	36.56190158450141
chr22	29711495	29711995	1415	500	+	2.561888829396137	0.0
chr22	29716405	29716985	1416	580	+	38.42833244094206	4.570237698062677
chr22	29738465	29738965	1417	500	+	20.495110635169095	18.280950792250707
chr22	29756645	29757165	1418	520	+	23.056999464565237	0.0
chr22	29760005	29760525	1419	520	+	256.1888829396137	18.280950792250707
chr22	29762845	29763345	1420	500	+	25.618888293961373	4.570237698062677
chr22	29765345	29765845	1421	500	+	117.84688615222231	41.13213928256408
chr22	29766325	29766825	1422	500	+	58.923443076111155	9.140475396125353
chr22	29778805	29779325	1423	520	+	125.53255264041073	210.23093411088308
chr22	29779585	29780185	1424	600	+	64.04722073490342	100.54522935737889
chr22	29783685	29784185	1425	500	+	30.742665952753647	63.98332777287747
chr22	29784322	29784865	1426	543	+	471.38754460888924	91.40475396125352
chr22	29789125	29789685	1427	560	+	38.42833244094206	9.140475396125353
chr22	29790885	29791385	1428	500	+	115.28499732282617	13.710713094188028
chr22	29800505	29801005	1429	500	+	25.618888293961373	0.0
chr22	29804945	29805445	1430	500	+	17.93322180577296	4.570237698062677
chr22	29808725	29809325	1431	600	+	40.99022127033819	0.0
chr22	29815945	29816485	1432	540	+	151.15144093437212	0.0
chr22	29818985	29819485	1433	500	+	20.495110635169095	4.570237698062677
chr22	29827885	29828385	1434	500	+	64.04722073490342	0.0
chr22	29834321	29834821	1435	500	+	7.685666488188412	0.0
chr22	29837868	29838368	1436	500	+	7.685666488188412	0.0
chr22	29853705	29854205	1437	500	+	105.03744200524163	18.280950792250707
chr22	29866305	29866805	1438	500	+	84.54233137007253	9.140475396125353
chr22	29873865	29874365	1439	500	+	105.03744200524163	18.280950792250707
chr22	29874385	29874885	1440	500	+	40.99022127033819	9.140475396125353
chr22	29875905	29876430	1441	525	+	28.180777123357508	4.570237698062677
chr22	29876785	29877325	1442	540	+	878.7278684828751	68.55356547094014
chr22	29877525	29878025	1443	500	+	102.47555317584549	100.54522935737889
chr22	29899925	29900425	1444	500	+	479.07321109707766	54.84285237675211
chr22	29916725	29917245	1445	520	+	48.675887758526606	68.55356547094014
chr22	29935045	29935585	1446	540	+	74.29477605248798	45.70237698062676
chr22	29949486	29950085	1447	599	+	619.9770967138652	173.6690325263817
chr22	29959545	29960065	1448	520	+	79.41855371128025	41.13213928256408
chr22	29965065	29965585	1449	520	+	84.54233137007253	86.83451626319085
chr22	29975685	29976345	1450	660	+	51.237776587922745	77.6940408670655
chr22	29976835	29977425	1451	590	+	294.61721538055576	100.54522935737889
chr22	29977685	29978205	1452	520	+	79.41855371128025	86.83451626319085
chr22	29978585	29979085	1453	500	+	35.86644361154592	9.140475396125353
chr22	29983945	29984445	1454	500	+	28.180777123357508	22.85118849031338
chr22	29985845	29986365	1455	520	+	84.54233137007253	36.56190158450141
chr22	29989865	29990365	1456	500	+	76.85666488188411	22.85118849031338
chr22	29993225	29993725	1457	500	+	20.495110635169095	4.570237698062677
chr22	29997325	29997825	1458	500	+	25.618888293961373	4.570237698062677
chr22	29999125	29999794	1459	669	+	1844.5599571652187	169.09879482831903
chr22	30000445	30001045	1460	600	+	89.6661090288648	68.55356547094014
chr22	30018025	30018525	1461	500	+	25.618888293961373	4.570237698062677
chr22	30019565	30020165	1462	600	+	43.552110099734335	41.13213928256408
chr22	30020325	30020885	1463	560	+	38.42833244094206	9.140475396125353
chr22	30021465	30022025	1464	560	+	130.65633029920298	9.140475396125353
chr22	30025345	30025845	1465	500	+	38.42833244094206	13.710713094188028
chr22	30029385	30029925	1466	540	+	53.79966541731888	36.56190158450141
chr22	30031665	30032165	1467	500	+	51.237776587922745	9.140475396125353
chr22	30054085	30054625	1468	540	+	38.42833244094206	9.140475396125353
chr22	30085645	30086145	1469	500	+	35.86644361154592	4.570237698062677
chr22	30097125	30097645	1470	520	+	133.21821912859915	22.85118849031338
chr22	30112665	30113165	1471	500	+	53.79966541731888	18.280950792250707
chr22	30116093	30116593	1472	500	+	0.0	0.0
chr22	30121985	30122505	1473	520	+	61.485331905507294	9.140475396125353
chr22	30123025	30123565	1474	540	+	53.79966541731888	0.0
chr22	30128085	30128625	1475	540	+	33.304554782149786	9.140475396125353
chr22	30129305	30129805	1476	500	+	35.86644361154592	4.570237698062677
chr22	30146485	30146985	1477	500	+	43.552110099734335	27.421426188376056
chr22	30147005	30147525	1478	520	+	99.91366434644934	54.84285237675211
chr22	30162105	30162625	1479	520	+	99.91366434644934	114.25594245156691
chr22	30162719	30163607	1480	888	+	845.4233137007253	831.7832610474071
chr22	30164165	30164665	1481	500	+	33.304554782149786	105.11546705544154
chr22	30168205	30168725	1482	520	+	79.41855371128025	18.280950792250707
chr22	30172545	30173125	1483	580	+	30.742665952753647	22.85118849031338
chr22	30176745	30177265	1484	520	+	878.7278684828751	123.39641784769225
chr22	30194285	30194785	1485	500	+	38.42833244094206	118.82618014962958
chr22	30195125	30195625	1486	500	+	320.23610367451715	260.5035487895725
chr22	30209485	30210025	1487	540	+	140.90388561678753	27.421426188376056
chr22	30217285	30217825	1488	540	+	1375.7343013857255	63.98332777287747
chr22	30223065	30224025	1489	960	+	94.78988668765707	18.280950792250707
chr22	30234043	30234625	1490	582	+	694.2718727663532	91.40475396125352
chr22	30236445	30236965	1491	520	+	315.1123260157249	27.421426188376056
chr22	30237525	30238225	1492	700	+	38.42833244094206	4.570237698062677
chr22	30238625	30239125	1493	500	+	40.99022127033819	9.140475396125353
chr22	30251525	30252025	1494	500	+	28.180777123357508	9.140475396125353
chr22	30267645	30268205	1495	560	+	110.16121966403391	18.280950792250707
chr22	30278845	30279805	1496	960	+	363.78821377425146	159.95831943219366
chr22	30297285	30297825	1497	540	+	74.29477605248798	9.140475396125353
chr22	30298485	30298985	1498	500	+	15.371332976376824	0.0
chr22	30303645	30304165	1499	520	+	1017.0698652702665	109.68570475350423
chr22	30308585	30309085	1500	500	+	25.618888293961373	18.280950792250707
chr22	30319905	30320405	1501	500	+	33.304554782149786	0.0
chr22	30334065	30334605	1502	540	+	53.79966541731888	13.710713094188028
chr22	30340205	30340785	1503	580	+	56.361554246715016	4.570237698062677
chr22	30342125	30342645	1504	520	+	84.54233137007253	18.280950792250707
chr22	30345725	30346225	1505	500	+	38.42833244094206	0.0
chr22	30348025	30348805	1506	780	+	676.3386509605803	265.07378648763523
chr22	30350145	30350645	1507	500	+	125.53255264041073	13.710713094188028
chr22	30362385	30362885	1508	500	+	17.93322180577296	0.0
chr22	30383925	30384425	1509	500	+	38.42833244094206	13.710713094188028
chr22	30390225	30390725	1510	500	+	46.113998929130474	36.56190158450141
chr22	30390905	30391405	1511	500	+	140.90388561678753	95.9749916593162
chr22	30394525	30395025	1512	500	+	30.742665952753647	0.0
chr22	30401145	30401665	1513	520	+	87.10422019946867	4.570237698062677
chr22	30410225	30410745	1514	520	+	174.20844039893734	41.13213928256408
chr22	30432585	30433105	1515	520	+	53.79966541731888	9.140475396125353
chr22	30443285	30443785	1516	500	+	30.742665952753647	4.570237698062677
chr22	30444485	30444985	1517	500	+	33.304554782149786	9.140475396125353
chr22	30450665	30451165	1518	500	+	25.618888293961373	4.570237698062677
chr22	30475807	30476719	1519	912	+	2.561888829396137	4.570237698062677
chr22	30484825	30485345	1520	520	+	189.57977337531415	0.0
chr22	30504545	30505065	1521	520	+	38.42833244094206	4.570237698062677
chr22	30523625	30524125	1522	500	+	51.237776587922745	4.570237698062677
chr22	30540345	30540845	1523	500	+	128.09444146980684	22.85118849031338
chr22	30577605	30578105	1524	500	+	28.180777123357508	4.570237698062677
chr22	30579785	30580305	1525	520	+	128.09444146980684	4.570237698062677
chr22	30591145	30591685	1526	540	+	64.04722073490342	22.85118849031338
chr22	30591965	30592525	1527	560	+	151.15144093437212	77.6940408670655
chr22	30604705	30605225	1528	520	+	207.51299518108712	246.7928356953845
chr22	30608465	30609025	1529	560	+	35.86644361154592	22.85118849031338
chr22	30612585	30613085	1530	500	+	438.0829898267395	91.40475396125352
chr22	30614985	30615505	1531	520	+	99.91366434644934	4.570237698062677
chr22	30634465	30635005	1532	540	+	43.552110099734335	13.710713094188028
chr22	30642590	30643090	1533	500	+	7.685666488188412	4.570237698062677
chr22	30651745	30652485	1534	740	+	89.6661090288648	31.991663886438737
chr22	30658785	30659305	1535	520	+	53.79966541731888	9.140475396125353
chr22	30661985	30662485	1536	500	+	30.742665952753647	18.280950792250707
chr22	30662582	30663082	1537	500	+	5.123777658792274	4.570237698062677
chr22	30666665	30667245	1538	580	+	53.79966541731888	13.710713094188028
chr22	30680145	30680645	1539	500	+	15.371332976376824	31.991663886438737
chr22	30682725	30683225	1540	500	+	43.552110099734335	27.421426188376056
chr22	30683745	30684265	1541	520	+	235.69377230444462	27.421426188376056
chr22	30685366	30685965	1542	599	+	397.09276855640127	27.421426188376056
chr22	30701425	30702525	1543	1100	+	220.32243932806782	114.25594245156691
chr22	30704445	30704945	1544	500	+	25.618888293961373	36.56190158450141
chr22	30705725	30706225	1545	500	+	17.93322180577296	4.570237698062677
chr22	30710765	30711345	1546	580	+	43.552110099734335	27.421426188376056
chr22	30721005	30721525	1547	520	+	66.60910956429957	45.70237698062676
chr22	30722705	30723345	1548	640	+	261.31266059840596	91.40475396125352
chr22	30723865	30724425	1549	560	+	94.78988668765707	59.41309007481479
chr22	30752373	30753205	1550	832	+	184.4559957165219	319.9166388643873
chr22	30773644	30774144	1551	500	+	7.685666488188412	13.710713094188028
chr22	30783052	30783745	1552	693	+	53.79966541731888	41.13213928256408
chr22	30787045	30787605	1553	560	+	128.09444146980684	82.26427856512817
chr22	30788585	30789185	1554	600	+	48.675887758526606	54.84285237675211
chr22	30792679	30793179	1555	500	+	5.123777658792274	0.0
chr22	30797985	30798505	1556	520	+	61.485331905507294	63.98332777287747
chr22	30804725	30805225	1557	500	+	207.51299518108712	27.421426188376056
chr22	30816345	30816865	1558	520	+	215.1986616692755	196.52022101669507
chr22	30817545	30818065	1559	520	+	358.6644361154592	351.9083027508261
chr22	30818725	30819265	1560	540	+	56.361554246715016	703.8166055016522
chr22	30819785	30820285	1561	500	+	1017.0698652702665	233.0821226011965
chr22	30820405	30820905	1562	500	+	89.6661090288648	333.6273519585754
chr22	30821360	30821885	1563	525	+	89.6661090288648	219.37140950700845
chr22	30822365	30822885	1564	520	+	58.923443076111155	118.82618014962958
chr22	30830685	30831305	1565	620	+	81.98044254067638	68.55356547094014
chr22	30834525	30835045	1566	520	+	35.86644361154592	22.85118849031338
chr22	30836985	30837525	1567	540	+	43.552110099734335	9.140475396125353
chr22	30838305	30838845	1568	540	+	130.65633029920298	41.13213928256408
chr22	30840425	30841565	1569	1140	+	274.1221047453867	155.388081734131
chr22	30847365	30847865	1570	500	+	133.21821912859915	0.0
chr22	30867784	30868284	1571	500	+	5.123777658792274	9.140475396125353
chr22	30877493	30877993	1572	500	+	17.93322180577296	4.570237698062677
chr22	30881285	30881825	1573	540	+	58.923443076111155	22.85118849031338
chr22	30886285	30886785	1574	500	+	28.180777123357508	13.710713094188028
chr22	30901448	30901948	1575	500	+	2.561888829396137	18.280950792250707
chr22	30902365	30902885	1576	520	+	210.07488401048326	219.37140950700845
chr22	30919705	30920225	1577	520	+	51.237776587922745	18.280950792250707
chr22	30933365	30933865	1578	500	+	7.685666488188412	22.85118849031338
chr22	30938445	30938985	1579	540	+	56.361554246715016	31.991663886438737
chr22	30942419	30942919	1580	500	+	7.685666488188412	4.570237698062677
chr22	30956525	30957045	1581	520	+	46.113998929130474	9.140475396125353
chr22	30968606	30969106	1582	500	+	5.123777658792274	4.570237698062677
chr22	30986965	30987485	1583	520	+	30.742665952753647	475.3047205985183
chr22	30987945	30988465	1584	520	+	599.4819860786962	356.47854044888874
chr22	30997925	30998425	1585	500	+	15.371332976376824	4.570237698062677
chr22	30999885	31000385	1586	500	+	23.056999464565237	22.85118849031338
chr22	31001485	31002005	1587	520	+	128.09444146980684	50.27261467868944
chr22	31002750	31003425	1588	675	+	92.22799785826095	132.53689324381762
chr22	31005205	31005725	1589	520	+	238.25566113384076	315.34640116632465
chr22	31026945	31027445	1590	500	+	5.123777658792274	0.0
chr22	31030325	31030845	1591	520	+	97.35177551705321	22.85118849031338
chr22	31031405	31032051	1592	646	+	130.65633029920298	41.13213928256408
chr22	31033525	31034025	1593	500	+	33.304554782149786	13.710713094188028
chr22	31040725	31041225	1594	500	+	33.304554782149786	4.570237698062677
chr22	31045285	31045805	1595	520	+	81.98044254067638	36.56190158450141
chr22	31046425	31046925	1596	500	+	66.60910956429957	36.56190158450141
chr22	31063605	31064165	1597	560	+	258.7507717690098	118.82618014962958
chr22	31070425	31070925	1598	500	+	94.78988668765707	41.13213928256408
chr22	31071385	31071905	1599	520	+	79.41855371128025	18.280950792250707
chr22	31077005	31077625	1600	620	+	28.180777123357508	4.570237698062677
chr22	31087065	31087565	1601	500	+	33.304554782149786	22.85118849031338
chr22	31090542	31091042	1602	500	+	5.123777658792274	9.140475396125353
chr22	31093945	31094445	1603	500	+	115.28499732282617	9.140475396125353
chr22	31097765	31098305	1604	540	+	30.742665952753647	13.710713094188028
chr22	31115765	31116305	1605	540	+	33.304554782149786	31.991663886438737
chr22	31116345	31116865	1606	520	+	76.85666488188411	36.56190158450141
chr22	31124765	31125265	1607	500	+	115.28499732282617	77.6940408670655
chr22	31135965	31136485	1608	520	+	61.485331905507294	13.710713094188028
chr22	31140165	31140685	1609	520	+	115.28499732282617	63.98332777287747
chr22	31151305	31151805	1610	500	+	58.923443076111155	0.0
chr22	31159685	31160185	1611	500	+	48.675887758526606	0.0
chr22	31198685	31199185	1612	500	+	117.84688615222231	0.0
chr22	31202305	31202805	1613	500	+	23.056999464565237	9.140475396125353
chr22	31268125	31268665	1614	540	+	79.41855371128025	59.41309007481479
chr22	31274885	31275385	1615	500	+	15.371332976376824	31.991663886438737
chr22	31277365	31277905	1616	540	+	210.07488401048326	315.34640116632465
chr22	31278865	31279365	1617	500	+	23.056999464565237	63.98332777287747
chr22	31316265	31316765	1618	500	+	46.113998929130474	0.0
chr22	31318044	31318544	1619	500	+	7.685666488188412	9.140475396125353
chr22	31358805	31359425	1620	620	+	40.99022127033819	13.710713094188028
chr22	31364023	31364785	1621	762	+	143.46577444618367	283.35473727988597
chr22	31364885	31365446	1622	561	+	479.07321109707766	265.07378648763523
chr22	31365625	31366165	1623	540	+	33.304554782149786	196.52022101669507
chr22	31386565	31387145	1624	580	+	53.79966541731888	13.710713094188028
chr22	31390825	31391405	1625	580	+	33.304554782149786	9.140475396125353
chr22	31392325	31392905	1626	580	+	56.361554246715016	0.0
chr22	31394285	31394805	1627	520	+	58.923443076111155	9.140475396125353
chr22	31442185	31443105	1628	920	+	102.47555317584549	77.6940408670655
chr22	31449025	31449605	1629	580	+	40.99022127033819	22.85118849031338
chr22	31455745	31456245	1630	500	+	76.85666488188411	132.53689324381762
chr22	31457025	31457565	1631	540	+	87.10422019946867	0.0
chr22	31459805	31460325	1632	520	+	340.73121430968627	237.65236029925916
chr22	31460665	31461265	1633	600	+	40.99022127033819	18.280950792250707
chr22	31476665	31477531	1634	866	+	315.1123260157249	242.22259799732186
chr22	31478505	31479025	1635	520	+	71.73288722309184	63.98332777287747
chr22	31479925	31480665	1636	740	+	66.60910956429957	283.35473727988597
chr22	31480685	31481565	1637	880	+	133.21821912859915	584.9904253520226
chr22	31482845	31483345	1638	500	+	28.180777123357508	41.13213928256408
chr22	31485025	31485525	1639	500	+	12.809444146980686	31.991663886438737
chr22	31494545	31495045	1640	500	+	28.180777123357508	0.0
chr22	31498325	31498865	1641	540	+	30.742665952753647	68.55356547094014
chr22	31503323	31504025	1642	702	+	602.0438749080923	68.55356547094014
chr22	31514405	31515525	1643	1120	+	74.29477605248798	59.41309007481479
chr22	31518658	31519158	1644	500	+	20.495110635169095	27.421426188376056
chr22	31523045	31523925	1645	880	+	84.54233137007253	68.55356547094014
chr22	31526805	31527345	1646	540	+	53.79966541731888	27.421426188376056
chr22	31536265	31536843	1647	578	+	56.361554246715016	4.570237698062677
chr22	31544905	31545445	1648	540	+	84.54233137007253	36.56190158450141
chr22	31555885	31556405	1649	520	+	176.77032922833345	109.68570475350423
chr22	31607905	31608425	1650	520	+	158.8371074225605	59.41309007481479
chr22	31609265	31609765	1651	500	+	30.742665952753647	50.27261467868944
chr22	31613345	31613865	1652	520	+	71.73288722309184	63.98332777287747
chr22	31618625	31619225	1653	600	+	81.98044254067638	9.140475396125353
chr22	31623765	31624265	1654	500	+	140.90388561678753	13.710713094188028
chr22	31625605	31626125	1655	520	+	76.85666488188411	82.26427856512817
chr22	31627125	31627625	1656	500	+	153.71332976376823	36.56190158450141
chr22	31637125	31637625	1657	500	+	20.495110635169095	4.570237698062677
chr22	31639885	31640405	1658	520	+	40.99022127033819	4.570237698062677
chr22	31644025	31644597	1659	572	+	140.90388561678753	22.85118849031338
chr22	31680425	31681005	1660	580	+	35.86644361154592	9.140475396125353
chr22	31686505	31687045	1661	540	+	192.1416622047103	164.52855713025633
chr22	31687705	31688205	1662	500	+	43.552110099734335	68.55356547094014
chr22	31688265	31688785	1663	520	+	228.0081058162562	45.70237698062676
chr22	31689565	31690065	1664	500	+	125.53255264041073	4.570237698062677
chr22	31691725	31692245	1665	520	+	122.97066381101459	63.98332777287747
chr22	31695885	31696385	1666	500	+	17.93322180577296	0.0
chr22	31709185	31709685	1667	500	+	35.86644361154592	4.570237698062677
chr22	31731084	31731584	1668	500	+	7.685666488188412	9.140475396125353
chr22	31741685	31742994	1669	1309	+	120.40877498161845	68.55356547094014
chr22	31746365	31746865	1670	500	+	35.86644361154592	0.0
chr22	31794205	31794705	1671	500	+	23.056999464565237	9.140475396125353
chr22	31795245	31795788	1672	543	+	507.2539882204352	406.75115512757816
chr22	31884645	31885145	1673	500	+	30.742665952753647	54.84285237675211
chr22	31885585	31886125	1674	540	+	81.98044254067638	187.37974562056974
chr22	31886365	31886885	1675	520	+	251.06510528082146	644.4035154268374
chr22	31891874	31892685	1676	811	+	343.2931031390824	118.82618014962958
chr22	31892865	31893365	1677	500	+	35.86644361154592	77.6940408670655
chr22	31913545	31914105	1678	560	+	38.42833244094206	31.991663886438737
chr22	31920065	31920585	1679	520	+	30.742665952753647	4.570237698062677
chr22	31926365	31926865	1680	500	+	38.42833244094206	18.280950792250707
chr22	31927025	31927565	1681	540	+	30.742665952753647	18.280950792250707
chr22	31928825	31929325	1682	500	+	40.99022127033819	18.280950792250707
chr22	31932985	31933505	1683	520	+	99.91366434644934	59.41309007481479
chr22	31952525	31953025	1684	500	+	51.237776587922745	9.140475396125353
chr22	31957205	31957725	1685	520	+	76.85666488188411	31.991663886438737
chr22	31981045	31981565	1686	520	+	407.3403238739858	132.53689324381762
chr22	31982285	31983125	1687	840	+	87.10422019946867	173.6690325263817
chr22	31986905	31987405	1688	500	+	10.247555317584547	0.0
chr22	31999065	31999565	1689	500	+	274.1221047453867	214.80117180894578
chr22	32014685	32015185	1690	500	+	43.552110099734335	13.710713094188028
chr22	32021565	32022085	1691	520	+	40.99022127033819	59.41309007481479
chr22	32022465	32022965	1692	500	+	366.3501026036476	278.78449958182324
chr22	32026625	32027125	1693	500	+	171.6465515695412	201.09045871475777
chr22	32029705	32030205	1694	500	+	61.485331905507294	31.991663886438737
chr22	32033445	32033945	1695	500	+	40.99022127033819	36.56190158450141
chr22	32042405	32042905	1696	500	+	48.675887758526606	50.27261467868944
chr22	32049245	32049745	1697	500	+	7.685666488188412	22.85118849031338
chr22	32056805	32057345	1698	540	+	40.99022127033819	31.991663886438737
chr22	32058005	32058800	1699	795	+	699.3956504251455	484.4451959946437
chr22	32061485	32062005	1700	520	+	99.91366434644934	13.710713094188028
chr22	32066785	32067305	1701	520	+	74.29477605248798	0.0
chr22	32073725	32074285	1702	560	+	120.40877498161845	31.991663886438737
chr22	32124705	32125265	1703	560	+	46.113998929130474	9.140475396125353
chr22	32140325	32140825	1704	500	+	15.371332976376824	4.570237698062677
chr22	32142045	32142545	1705	500	+	30.742665952753647	9.140475396125353
chr22	32145505	32146485	1706	980	+	445.7686563149279	776.940408670655
chr22	32146785	32147305	1707	520	+	35.86644361154592	159.95831943219366
chr22	32148845	32149345	1708	500	+	240.8175499632369	265.07378648763523
chr22	32149625	32150258	1709	633	+	379.1595467506283	470.7344829004557
chr22	32160705	32161245	1710	540	+	138.34199678739142	100.54522935737889
chr22	32170865	32171405	1711	540	+	94.78988668765707	22.85118849031338
chr22	32185705	32186205	1712	500	+	133.21821912859915	36.56190158450141
chr22	32225345	32225885	1713	540	+	74.29477605248798	18.280950792250707
chr22	32225925	32226425	1714	500	+	28.180777123357508	9.140475396125353
chr22	32253205	32253725	1715	520	+	38.42833244094206	27.421426188376056
chr22	32263305	32263805	1716	500	+	161.39899625195665	18.280950792250707
chr22	32268225	32268725	1717	500	+	105.03744200524163	13.710713094188028
chr22	32272165	32272665	1718	500	+	156.27521859316437	22.85118849031338
chr22	32274245	32274745	1719	500	+	10.247555317584547	13.710713094188028
chr22	32277165	32277665	1720	500	+	107.59933083463775	77.6940408670655
chr22	32285045	32285565	1721	520	+	38.42833244094206	18.280950792250707
chr22	32287345	32288185	1722	840	+	386.8452132388167	607.841613842336
chr22	32289805	32290305	1723	500	+	46.113998929130474	105.11546705544154
chr22	32291385	32292285	1724	900	+	668.6529844723918	589.5606630500853
chr22	32292425	32292945	1725	520	+	448.330545144324	123.39641784769225
chr22	32297325	32298145	1726	820	+	430.397323338551	159.95831943219366
chr22	32307565	32308185	1727	620	+	33.304554782149786	18.280950792250707
chr22	32311365	32311865	1728	500	+	28.180777123357508	4.570237698062677
chr22	32319125	32319625	1729	500	+	30.742665952753647	50.27261467868944
chr22	32322945	32323445	1730	500	+	28.180777123357508	9.140475396125353
chr22	32325145	32325665	1731	520	+	51.237776587922745	36.56190158450141
chr22	32332245	32332745	1732	500	+	43.552110099734335	68.55356547094014
chr22	32333285	32333805	1733	520	+	174.20844039893734	95.9749916593162
chr22	32333885	32334385	1734	500	+	17.93322180577296	63.98332777287747
chr22	32338465	32338965	1735	500	+	30.742665952753647	86.83451626319085
chr22	32339745	32340728	1736	983	+	327.9217701627055	680.9654170113387
chr22	32341098	32341598	1737	500	+	28.180777123357508	411.3213928256409
chr22	32342165	32342665	1738	500	+	58.923443076111155	223.94164720507112
chr22	32343145	32343685	1739	540	+	99.91366434644934	50.27261467868944
chr22	32346465	32346965	1740	500	+	51.237776587922745	73.12380316900283
chr22	32354525	32355165	1741	640	+	51.237776587922745	4.570237698062677
chr22	32355225	32355725	1742	500	+	35.86644361154592	0.0
chr22	32355965	32356465	1743	500	+	28.180777123357508	0.0
chr22	32358625	32359125	1744	500	+	25.618888293961373	9.140475396125353
chr22	32363305	32363805	1745	500	+	23.056999464565237	18.280950792250707
chr22	32365985	32366505	1746	520	+	94.78988668765707	18.280950792250707
chr22	32366525	32367045	1747	520	+	133.21821912859915	22.85118849031338
chr22	32373065	32373585	1748	520	+	97.35177551705321	13.710713094188028
chr22	32416105	32416625	1749	520	+	35.86644361154592	9.140475396125353
chr22	32419225	32419785	1750	560	+	46.113998929130474	9.140475396125353
chr22	32446585	32447105	1751	520	+	71.73288722309184	41.13213928256408
chr22	32454906	32455406	1752	500	+	5.123777658792274	4.570237698062677
chr22	32517713	32518213	1753	500	+	12.809444146980686	13.710713094188028
chr22	32531885	32532385	1754	500	+	84.54233137007253	4.570237698062677
chr22	32554993	32555493	1755	500	+	2.561888829396137	0.0
chr22	32599214	32599714	1756	500	+	0.0	0.0
chr22	32651068	32651568	1757	500	+	2.561888829396137	9.140475396125353
chr22	32662085	32662585	1758	500	+	38.42833244094206	4.570237698062677
chr22	32753603	32754103	1759	500	+	0.0	0.0
chr22	32766813	32767313	1760	500	+	5.123777658792274	13.710713094188028
chr22	32772400	32772900	1761	500	+	2.561888829396137	9.140475396125353
chr22	32774625	32775125	1762	500	+	35.86644361154592	0.0
chr22	32807145	32807645	1763	500	+	51.237776587922745	82.26427856512817
chr22	32808005	32808565	1764	560	+	317.674214845121	205.66069641282044
chr22	32810005	32810565	1765	560	+	74.29477605248798	22.85118849031338
chr22	32816165	32816725	1766	560	+	35.86644361154592	0.0
chr22	32853123	32853623	1767	500	+	2.561888829396137	4.570237698062677
chr22	32865745	32866245	1768	500	+	148.58955210497595	50.27261467868944
chr22	32869205	32869765	1769	560	+	135.78010795799528	27.421426188376056
chr22	32870385	32870905	1770	520	+	240.8175499632369	164.52855713025633
chr22	32870973	32871565	1771	592	+	89.6661090288648	278.78449958182324
chr22	32878645	32879185	1772	540	+	228.0081058162562	54.84285237675211
chr22	32881865	32882365	1773	500	+	25.618888293961373	13.710713094188028
chr22	32884145	32884745	1774	600	+	76.85666488188411	31.991663886438737
chr22	32910985	32911565	1775	580	+	53.79966541731888	9.140475396125353
chr22	32924865	32925385	1776	520	+	28.180777123357508	0.0
chr22	32928205	32929045	1777	840	+	89.6661090288648	109.68570475350423
chr22	32935525	32936185	1778	660	+	56.361554246715016	27.421426188376056
chr22	32968625	32969125	1779	500	+	69.17099839369571	146.24760633800565
chr22	32972425	32972925	1780	500	+	64.04722073490342	191.9499833186324
chr22	33045405	33045905	1781	500	+	61.485331905507294	27.421426188376056
chr22	33046825	33047325	1782	500	+	30.742665952753647	9.140475396125353
chr22	33171945	33172445	1783	500	+	10.247555317584547	4.570237698062677
chr22	33196551	33197051	1784	500	+	5.123777658792274	4.570237698062677
chr22	33218985	33219485	1785	500	+	35.86644361154592	0.0
chr22	33269505	33270045	1786	540	+	215.1986616692755	73.12380316900283
chr22	33276945	33277665	1787	720	+	842.8614248713292	260.5035487895725
chr22	33277905	33278405	1788	500	+	374.0357690918361	73.12380316900283
chr22	33282785	33283725	1789	940	+	263.87454942780215	86.83451626319085
chr22	33290885	33291385	1790	500	+	20.495110635169095	4.570237698062677
chr22	33293365	33293885	1791	520	+	56.361554246715016	13.710713094188028
chr22	33299925	33300485	1792	560	+	53.79966541731888	18.280950792250707
chr22	33322525	33323045	1793	520	+	30.742665952753647	4.570237698062677
chr22	33381945	33382465	1794	520	+	76.85666488188411	22.85118849031338
chr22	33402556	33403056	1795	500	+	2.561888829396137	4.570237698062677
chr22	33414105	33414605	1796	500	+	28.180777123357508	9.140475396125353
chr22	33445025	33445525	1797	500	+	40.99022127033819	4.570237698062677
chr22	33504264	33504764	1798	500	+	0.0	4.570237698062677
chr22	33834125	33834625	1799	500	+	30.742665952753647	13.710713094188028
chr22	34120721	34121221	1800	500	+	2.561888829396137	0.0
chr22	34316166	34316666	1801	500	+	0.0	0.0
chr22	34451745	34452245	1802	500	+	30.742665952753647	0.0
chr22	34616505	34617005	1803	500	+	33.304554782149786	4.570237698062677
chr22	34806025	34806625	1804	600	+	53.79966541731888	4.570237698062677
chr22	34810745	34811305	1805	560	+	56.361554246715016	4.570237698062677
chr22	35245125	35245625	1806	500	+	17.93322180577296	4.570237698062677
chr22	35393655	35394155	1807	500	+	5.123777658792274	4.570237698062677
chr22	35419985	35420485	1808	500	+	30.742665952753647	18.280950792250707
chr22	35452345	35452865	1809	520	+	25.618888293961373	31.991663886438737
chr22	35460585	35461085	1810	500	+	238.25566113384076	123.39641784769225
chr22	35461845	35462378	1811	533	+	12.809444146980686	45.70237698062676
chr22	35495885	35496385	1812	500	+	25.618888293961373	41.13213928256408
chr22	35498565	35499085	1813	520	+	81.98044254067638	27.421426188376056
chr22	35527525	35528045	1814	520	+	304.8647706981403	54.84285237675211
chr22	35530545	35531045	1815	500	+	40.99022127033819	36.56190158450141
chr22	35546465	35547005	1816	540	+	76.85666488188411	22.85118849031338
chr22	35550785	35551285	1817	500	+	56.361554246715016	9.140475396125353
chr22	35552245	35552745	1818	500	+	23.056999464565237	36.56190158450141
chr22	35599465	35599965	1819	500	+	15.371332976376824	9.140475396125353
chr22	35605125	35605645	1820	520	+	74.29477605248798	13.710713094188028
chr22	35607925	35608425	1821	500	+	471.38754460888924	86.83451626319085
chr22	35611965	35612485	1822	520	+	161.39899625195665	50.27261467868944
chr22	35614925	35615465	1823	540	+	151.15144093437212	27.421426188376056
chr22	35625825	35626325	1824	500	+	12.809444146980686	73.12380316900283
chr22	35626799	35627345	1825	546	+	187.01788454591804	100.54522935737889
chr22	35627405	35627925	1826	520	+	120.40877498161845	50.27261467868944
chr22	35653145	35653694	1827	549	+	156.27521859316437	155.388081734131
chr22	35654445	35655365	1828	920	+	105.03744200524163	91.40475396125352
chr22	35694625	35695125	1829	500	+	43.552110099734335	45.70237698062676
chr22	35695245	35696425	1830	1180	+	786.4998706246141	708.3868431997148
chr22	35697465	35697985	1831	520	+	146.0276632755798	109.68570475350423
chr22	35706505	35707005	1832	500	+	33.304554782149786	4.570237698062677
chr22	35709225	35709725	1833	500	+	30.742665952753647	22.85118849031338
chr22	35746705	35747245	1834	540	+	179.3322180577296	45.70237698062676
chr22	35751665	35752405	1835	740	+	35.86644361154592	31.991663886438737
chr22	35760145	35760645	1836	500	+	10.247555317584547	9.140475396125353
chr22	35767805	35768325	1837	520	+	371.47388026243993	287.9249749779486
chr22	35768525	35769065	1838	540	+	117.84688615222231	27.421426188376056
chr22	35772865	35773365	1839	500	+	625.1008743726575	361.0487781469514
chr22	35773485	35773985	1840	500	+	28.180777123357508	118.82618014962958
chr22	35776809	35777309	1841	500	+	2.561888829396137	4.570237698062677
chr22	35784765	35785265	1842	500	+	66.60910956429957	22.85118849031338
chr22	35789845	35790365	1843	520	+	66.60910956429957	63.98332777287747
chr22	35790765	35791305	1844	540	+	71.73288722309184	27.421426188376056
chr22	35795765	35796365	1845	600	+	609.7295413962806	361.0487781469514
chr22	35832965	35833505	1846	540	+	51.237776587922745	18.280950792250707
chr22	35843765	35844305	1847	540	+	135.78010795799528	95.9749916593162
chr22	35873865	35874385	1848	520	+	202.38921752229484	9.140475396125353
chr22	35876405	35876905	1849	500	+	40.99022127033819	22.85118849031338
chr22	35887765	35888265	1850	500	+	28.180777123357508	54.84285237675211
chr22	35917685	35918205	1851	520	+	84.54233137007253	0.0
chr22	35924885	35925385	1852	500	+	30.742665952753647	0.0
chr22	35937101	35937601	1853	500	+	0.0	0.0
chr22	35944265	35944825	1854	560	+	28.180777123357508	9.140475396125353
chr22	35948105	35948945	1855	840	+	181.89410688712573	9.140475396125353
chr22	35957785	35958305	1856	520	+	38.42833244094206	9.140475396125353
chr22	35978965	35979525	1857	560	+	46.113998929130474	9.140475396125353
chr22	35985145	35985645	1858	500	+	25.618888293961373	9.140475396125353
chr22	36000805	36001345	1859	540	+	38.42833244094206	18.280950792250707
chr22	36011285	36011785	1860	500	+	17.93322180577296	50.27261467868944
chr22	36013134	36013634	1861	500	+	2.561888829396137	4.570237698062677
chr22	36023645	36024145	1862	500	+	17.93322180577296	4.570237698062677
chr22	36025925	36026445	1863	520	+	74.29477605248798	22.85118849031338
chr22	36027565	36028125	1864	560	+	33.304554782149786	18.280950792250707
chr22	36030045	36030565	1865	520	+	130.65633029920298	0.0
chr22	36030945	36031485	1866	540	+	66.60910956429957	18.280950792250707
chr22	36044173	36044673	1867	500	+	28.180777123357508	91.40475396125352
chr22	36044765	36045265	1868	500	+	40.99022127033819	137.10713094188029
chr22	36052285	36052825	1869	540	+	40.99022127033819	9.140475396125353
chr22	36053865	36054365	1870	500	+	35.86644361154592	36.56190158450141
chr22	36113668	36114168	1871	500	+	0.0	0.0
chr22	36117845	36118445	1872	600	+	61.485331905507294	41.13213928256408
chr22	36123485	36123985	1873	500	+	130.65633029920298	41.13213928256408
chr22	36138285	36138785	1874	500	+	561.053653637754	223.94164720507112
chr22	36181945	36182445	1875	500	+	33.304554782149786	18.280950792250707
chr22	36207025	36207585	1876	560	+	38.42833244094206	4.570237698062677
chr22	36217665	36218165	1877	500	+	33.304554782149786	13.710713094188028
chr22	36229965	36230545	1878	580	+	40.99022127033819	9.140475396125353
chr22	36232225	36232745	1879	520	+	35.86644361154592	18.280950792250707
chr22	36236325	36236880	1880	555	+	304.8647706981403	13.710713094188028
chr22	36276105	36276605	1881	500	+	107.59933083463775	4.570237698062677
chr22	36288145	36288685	1882	540	+	30.742665952753647	0.0
chr22	36299065	36299665	1883	600	+	48.675887758526606	9.140475396125353
chr22	36299965	36300505	1884	540	+	61.485331905507294	13.710713094188028
chr22	36301945	36302445	1885	500	+	30.742665952753647	4.570237698062677
chr22	36302905	36303405	1886	500	+	30.742665952753647	18.280950792250707
chr22	36306905	36307405	1887	500	+	33.304554782149786	4.570237698062677
chr22	36310485	36311005	1888	520	+	212.63677283987937	63.98332777287747
chr22	36317685	36318245	1889	560	+	181.89410688712573	13.710713094188028
chr22	36326925	36327445	1890	520	+	66.60910956429957	13.710713094188028
chr22	36328805	36329385	1891	580	+	56.361554246715016	13.710713094188028
chr22	36332165	36332685	1892	520	+	40.99022127033819	27.421426188376056
chr22	36353245	36353745	1893	500	+	28.180777123357508	9.140475396125353
chr22	36354985	36355585	1894	600	+	35.86644361154592	4.570237698062677
chr22	36369425	36369945	1895	520	+	30.742665952753647	22.85118849031338
chr22	36390665	36391165	1896	500	+	33.304554782149786	13.710713094188028
chr22	36391345	36391905	1897	560	+	133.21821912859915	36.56190158450141
chr22	36398065	36398605	1898	540	+	105.03744200524163	41.13213928256408
chr22	36398885	36399385	1899	500	+	74.29477605248798	63.98332777287747
chr22	36405985	36406565	1900	580	+	156.27521859316437	22.85118849031338
chr22	36413545	36414045	1901	500	+	23.056999464565237	4.570237698062677
chr22	36415045	36415585	1902	540	+	30.742665952753647	27.421426188376056
chr22	36418185	36418685	1903	500	+	79.41855371128025	13.710713094188028
chr22	36424665	36425485	1904	820	+	440.64487865613563	127.96665554575495
chr22	36431485	36431985	1905	500	+	38.42833244094206	9.140475396125353
chr22	36432065	36432565	1906	500	+	43.552110099734335	45.70237698062676
chr22	36445085	36445925	1907	840	+	161.39899625195665	100.54522935737889
chr22	36448565	36449065	1908	500	+	309.9885483569326	461.5940075043303
chr22	36449905	36450405	1909	500	+	28.180777123357508	27.421426188376056
chr22	36461785	36462725	1910	940	+	217.76055049867165	521.007097579145
chr22	36476945	36477505	1911	560	+	40.99022127033819	45.70237698062676
chr22	36482125	36482645	1912	520	+	33.304554782149786	36.56190158450141
chr22	36485025	36485585	1913	560	+	58.923443076111155	13.710713094188028
chr22	36500405	36500965	1914	560	+	33.304554782149786	18.280950792250707
chr22	36501025	36501585	1915	560	+	30.742665952753647	4.570237698062677
chr22	36516625	36517145	1916	520	+	25.618888293961373	9.140475396125353
chr22	36519905	36520445	1917	540	+	210.07488401048326	100.54522935737889
chr22	36541045	36541565	1918	520	+	71.73288722309184	4.570237698062677
chr22	36552765	36553265	1919	500	+	25.618888293961373	59.41309007481479
chr22	36556727	36557227	1920	500	+	2.561888829396137	13.710713094188028
chr22	36568865	36569365	1921	500	+	17.93322180577296	0.0
chr22	36573105	36573605	1922	500	+	38.42833244094206	4.570237698062677
chr22	36576245	36576745	1923	500	+	48.675887758526606	22.85118849031338
chr22	36578005	36578585	1924	580	+	76.85666488188411	31.991663886438737
chr22	36580245	36580745	1925	500	+	28.180777123357508	4.570237698062677
chr22	36590905	36591405	1926	500	+	20.495110635169095	4.570237698062677
chr22	36593025	36593525	1927	500	+	153.71332976376823	27.421426188376056
chr22	36593585	36594165	1928	580	+	69.17099839369571	77.6940408670655
chr22	36597645	36598205	1929	560	+	379.1595467506283	123.39641784769225
chr22	36598825	36599325	1930	500	+	25.618888293961373	9.140475396125353
chr22	36600629	36601129	1931	500	+	23.056999464565237	4.570237698062677
chr22	36607165	36607665	1932	500	+	48.675887758526606	9.140475396125353
chr22	36613445	36613945	1933	500	+	28.180777123357508	4.570237698062677
chr22	36617745	36618245	1934	500	+	58.923443076111155	4.570237698062677
chr22	36635425	36636250	1935	825	+	330.48365899210165	223.94164720507112
chr22	36643965	36644465	1936	500	+	25.618888293961373	13.710713094188028
chr22	36648865	36649366	1937	501	+	128.09444146980684	169.09879482831903
chr22	36650045	36650585	1938	540	+	38.42833244094206	36.56190158450141
chr22	36650865	36651385	1939	520	+	189.57977337531415	114.25594245156691
chr22	36654785	36655765	1940	980	+	163.96088508135276	214.80117180894578
chr22	36659345	36660245	1941	900	+	66.60910956429957	27.421426188376056
chr22	36682465	36682965	1942	500	+	69.17099839369571	22.85118849031338
chr22	36697285	36697785	1943	500	+	23.056999464565237	9.140475396125353
chr22	36724665	36725665	1944	1000	+	407.3403238739858	571.2797122578346
chr22	36726585	36727285	1945	700	+	74.29477605248798	342.7678273547007
chr22	36727445	36727945	1946	500	+	166.52277391074892	388.4702043353275
chr22	36728665	36729245	1947	580	+	58.923443076111155	169.09879482831903
chr22	36730305	36730825	1948	520	+	289.4934377217635	187.37974562056974
chr22	36736605	36737105	1949	500	+	28.180777123357508	22.85118849031338
chr22	36750965	36751545	1950	580	+	38.42833244094206	114.25594245156691
chr22	36760985	36761525	1951	540	+	169.08466274014506	36.56190158450141
chr22	36764465	36764985	1952	520	+	906.9086456062325	50.27261467868944
chr22	36765005	36765505	1953	500	+	25.618888293961373	68.55356547094014
chr22	36765985	36766505	1954	520	+	197.26543986350256	68.55356547094014
chr22	36767125	36767625	1955	500	+	74.29477605248798	59.41309007481479
chr22	36773065	36773565	1956	500	+	151.15144093437212	9.140475396125353
chr22	36779165	36779685	1957	520	+	171.6465515695412	22.85118849031338
chr22	36782285	36782865	1958	580	+	40.99022127033819	105.11546705544154
chr22	36783862	36784485	1959	623	+	1283.5063035274648	114.25594245156691
chr22	36786985	36787485	1960	500	+	12.809444146980686	9.140475396125353
chr22	36787625	36788145	1961	520	+	69.17099839369571	82.26427856512817
chr22	36791905	36792405	1962	500	+	28.180777123357508	27.421426188376056
chr22	36794505	36795005	1963	500	+	30.742665952753647	4.570237698062677
chr22	36795305	36795805	1964	500	+	33.304554782149786	18.280950792250707
chr22	36801405	36801905	1965	500	+	25.618888293961373	13.710713094188028
chr22	36805985	36806525	1966	540	+	81.98044254067638	4.570237698062677
chr22	36808945	36809485	1967	540	+	28.180777123357508	18.280950792250707
chr22	36815205	36815745	1968	540	+	338.1693254802901	36.56190158450141
chr22	36818605	36819125	1969	520	+	76.85666488188411	27.421426188376056
chr22	36819405	36819925	1970	520	+	443.20676748553177	77.6940408670655
chr22	36820465	36820985	1971	520	+	30.742665952753647	18.280950792250707
chr22	36822185	36822685	1972	500	+	140.90388561678753	45.70237698062676
chr22	36822925	36823425	1973	500	+	66.60910956429957	13.710713094188028
chr22	36826845	36827365	1974	520	+	69.17099839369571	31.991663886438737
chr22	36835745	36836285	1975	540	+	48.675887758526606	31.991663886438737
chr22	36841245	36841765	1976	520	+	61.485331905507294	36.56190158450141
chr22	36847745	36848285	1977	540	+	425.27354567975874	178.23927022444437
chr22	36850965	36851465	1978	500	+	263.87454942780215	105.11546705544154
chr22	36855525	36856025	1979	500	+	40.99022127033819	27.421426188376056
chr22	36863285	36863785	1980	500	+	35.86644361154592	59.41309007481479
chr22	36863985	36864505	1981	520	+	189.57977337531415	137.10713094188029
chr22	36866185	36867185	1982	1000	+	110.16121966403391	86.83451626319085
chr22	36875005	36875525	1983	520	+	374.0357690918361	159.95831943219366
chr22	36876085	36876585	1984	500	+	443.20676748553177	457.02376980626764
chr22	36877185	36878345	1985	1160	+	578.986875443527	1101.427285233105
chr22	36878645	36879145	1986	500	+	28.180777123357508	31.991663886438737
chr22	36882545	36883125	1987	580	+	43.552110099734335	13.710713094188028
chr22	36902625	36903745	1988	1120	+	317.674214845121	374.7594912411395
chr22	36904625	36905125	1989	500	+	40.99022127033819	13.710713094188028
chr22	36906985	36907505	1990	520	+	66.60910956429957	27.421426188376056
chr22	36923785	36924285	1991	500	+	33.304554782149786	27.421426188376056
chr22	36925027	36925605	1992	578	+	1275.8206370392763	315.34640116632465
chr22	36938045	36938565	1993	520	+	117.84688615222231	73.12380316900283
chr22	36940185	36940845	1994	660	+	61.485331905507294	31.991663886438737
chr22	36942165	36942685	1995	520	+	128.09444146980684	31.991663886438737
chr22	36956005	36956505	1996	500	+	17.93322180577296	4.570237698062677
chr22	37040205	37040765	1997	560	+	58.923443076111155	9.140475396125353
chr22	37055725	37056245	1998	520	+	266.4364382571983	54.84285237675211
chr22	37098440	37098940	1999	500	+	7.685666488188412	0.0
chr22	37099670	37100170	2000	500	+	0.0	4.570237698062677
chr22	37137405	37137905	2001	500	+	33.304554782149786	0.0
chr22	37171927	37172665	2002	738	+	335.607436650894	13.710713094188028
chr22	37178045	37178545	2003	500	+	20.495110635169095	9.140475396125353
chr22	37215267	37215767	2004	500	+	0.0	9.140475396125353
chr22	37242225	37242785	2005	560	+	38.42833244094206	13.710713094188028
chr22	37252285	37252805	2006	520	+	89.6661090288648	4.570237698062677
chr22	37256779	37257279	2007	500	+	17.93322180577296	4.570237698062677
chr22	37269605	37270105	2008	500	+	30.742665952753647	4.570237698062677
chr22	37309424	37309924	2009	500	+	15.371332976376824	13.710713094188028
chr22	37336545	37337065	2010	520	+	33.304554782149786	0.0
chr22	37361038	37361538	2011	500	+	0.0	9.140475396125353
chr22	37373305	37373885	2012	580	+	76.85666488188411	18.280950792250707
chr22	37373965	37374485	2013	520	+	158.8371074225605	22.85118849031338
chr22	37376625	37377145	2014	520	+	40.99022127033819	22.85118849031338
chr22	37378145	37378685	2015	540	+	279.24588240417893	173.6690325263817
chr22	37394525	37395025	2016	500	+	30.742665952753647	13.710713094188028
chr22	37403627	37404127	2017	500	+	0.0	0.0
chr22	37410825	37411325	2018	500	+	151.15144093437212	50.27261467868944
chr22	37412105	37412605	2019	500	+	130.65633029920298	27.421426188376056
chr22	37415432	37416825	2020	1393	+	74.29477605248798	388.4702043353275
chr22	37417865	37418365	2021	500	+	38.42833244094206	27.421426188376056
chr22	37427205	37427705	2022	500	+	30.742665952753647	13.710713094188028
chr22	37427845	37428385	2023	540	+	48.675887758526606	4.570237698062677
chr22	37436765	37437285	2024	520	+	28.180777123357508	0.0
chr22	37439965	37440485	2025	520	+	40.99022127033819	13.710713094188028
chr22	37447425	37448025	2026	600	+	40.99022127033819	0.0
chr22	37473785	37474285	2027	500	+	30.742665952753647	13.710713094188028
chr22	37484045	37484565	2028	520	+	48.675887758526606	0.0
chr22	37505199	37505699	2029	500	+	5.123777658792274	4.570237698062677
chr22	37537905	37538405	2030	500	+	56.361554246715016	13.710713094188028
chr22	37545805	37546425	2031	620	+	61.485331905507294	9.140475396125353
chr22	37557385	37558005	2032	620	+	38.42833244094206	13.710713094188028
chr22	37562465	37563025	2033	560	+	79.41855371128025	22.85118849031338
chr22	37570846	37571346	2034	500	+	2.561888829396137	13.710713094188028
chr22	37572445	37572945	2035	500	+	33.304554782149786	13.710713094188028
chr22	37582185	37582705	2036	520	+	143.46577444618367	9.140475396125353
chr22	37584080	37584580	2037	500	+	12.809444146980686	9.140475396125353
chr22	37586225	37586745	2038	520	+	66.60910956429957	18.280950792250707
chr22	37589745	37590245	2039	500	+	386.8452132388167	36.56190158450141
chr22	37592805	37593305	2040	500	+	28.180777123357508	0.0
chr22	37593665	37594165	2041	500	+	20.495110635169095	36.56190158450141
chr22	37594405	37594945	2042	540	+	110.16121966403391	31.991663886438737
chr22	37595305	37595805	2043	500	+	719.8907610603145	123.39641784769225
chr22	37608085	37608666	2044	581	+	35.86644361154592	13.710713094188028
chr22	37612385	37612885	2045	500	+	30.742665952753647	0.0
chr22	37618705	37619205	2046	500	+	12.809444146980686	22.85118849031338
chr22	37625965	37626465	2047	500	+	71.73288722309184	228.51188490313382
chr22	37638425	37638965	2048	540	+	684.0243174487687	297.065450374074
chr22	37640089	37640665	2049	576	+	179.3322180577296	169.09879482831903
chr22	37641745	37642245	2050	500	+	35.86644361154592	0.0
chr22	37649125	37649625	2051	500	+	35.86644361154592	9.140475396125353
chr22	37650825	37651365	2052	540	+	81.98044254067638	4.570237698062677
chr22	37654985	37656025	2053	1040	+	115.28499732282617	41.13213928256408
chr22	37656805	37657305	2054	500	+	46.113998929130474	9.140475396125353
chr22	37669425	37669965	2055	540	+	128.09444146980684	105.11546705544154
chr22	37670485	37670985	2056	500	+	23.056999464565237	27.421426188376056
chr22	37677565	37678065	2057	500	+	30.742665952753647	13.710713094188028
chr22	37678173	37678745	2058	572	+	20.495110635169095	18.280950792250707
chr22	37680945	37681445	2059	500	+	5.123777658792274	0.0
chr22	37693785	37694325	2060	540	+	53.79966541731888	9.140475396125353
chr22	37697845	37698365	2061	520	+	43.552110099734335	13.710713094188028
chr22	37699805	37700425	2062	620	+	58.923443076111155	91.40475396125352
chr22	37700565	37701085	2063	520	+	61.485331905507294	155.388081734131
chr22	37702745	37703505	2064	760	+	199.82732869289867	155.388081734131
chr22	37703565	37704065	2065	500	+	53.79966541731888	127.96665554575495
chr22	37705605	37706545	2066	940	+	69.17099839369571	36.56190158450141
chr22	37710745	37711245	2067	500	+	15.371332976376824	22.85118849031338
chr22	37712825	37713325	2068	500	+	51.237776587922745	4.570237698062677
chr22	37726405	37726925	2069	520	+	38.42833244094206	9.140475396125353
chr22	37750629	37751129	2070	500	+	0.0	13.710713094188028
chr22	37823255	37823755	2071	500	+	2.561888829396137	0.0
chr22	37851345	37851885	2072	540	+	135.78010795799528	27.421426188376056
chr22	37853245	37853805	2073	560	+	43.552110099734335	4.570237698062677
chr22	37882228	37883065	2074	837	+	20.495110635169095	22.85118849031338
chr22	37888765	37889285	2075	520	+	64.04722073490342	0.0
chr22	37897585	37898085	2076	500	+	25.618888293961373	18.280950792250707
chr22	37908425	37908945	2077	520	+	199.82732869289867	54.84285237675211
chr22	37914960	37915825	2078	865	+	30.742665952753647	22.85118849031338
chr22	37916785	37917285	2079	500	+	56.361554246715016	13.710713094188028
chr22	37929865	37930365	2080	500	+	89.6661090288648	13.710713094188028
chr22	37934705	37935245	2081	540	+	256.1888829396137	27.421426188376056
chr22	37941045	37941585	2082	540	+	51.237776587922745	18.280950792250707
chr22	37948645	37949145	2083	500	+	614.8533190550729	77.6940408670655
chr22	37955925	37956720	2084	795	+	48.675887758526606	164.52855713025633
chr22	37957645	37958145	2085	500	+	171.6465515695412	521.007097579145
chr22	37959265	37959805	2086	540	+	120.40877498161845	159.95831943219366
chr22	37963045	37963705	2087	660	+	53.79966541731888	13.710713094188028
chr22	37965345	37966125	2088	780	+	76.85666488188411	18.280950792250707
chr22	37966565	37967225	2089	660	+	56.361554246715016	18.280950792250707
chr22	37975774	37976465	2090	691	+	71.73288722309184	0.0
chr22	37988385	37988885	2091	500	+	161.39899625195665	0.0
chr22	37995065	37995605	2092	540	+	69.17099839369571	13.710713094188028
chr22	37997505	37998085	2093	580	+	458.57810046190855	77.6940408670655
chr22	38002985	38003505	2094	520	+	161.39899625195665	22.85118849031338
chr22	38004230	38004965	2095	735	+	609.7295413962806	461.5940075043303
chr22	38005805	38006345	2096	540	+	46.113998929130474	306.2059257701993
chr22	38006685	38007205	2097	520	+	51.237776587922745	100.54522935737889
chr22	38026965	38027525	2098	560	+	105.03744200524163	13.710713094188028
chr22	38029825	38031005	2099	1180	+	391.968990897609	159.95831943219366
chr22	38035365	38035933	2100	568	+	25.618888293961373	18.280950792250707
chr22	38039185	38039725	2101	540	+	35.86644361154592	41.13213928256408
chr22	38053445	38054025	2102	580	+	207.51299518108712	301.6356880721366
chr22	38054134	38054986	2103	852	+	1286.068192356861	470.7344829004557
chr22	38055865	38056405	2104	540	+	43.552110099734335	82.26427856512817
chr22	38057245	38057785	2105	540	+	61.485331905507294	132.53689324381762
chr22	38063965	38064465	2106	500	+	181.89410688712573	18.280950792250707
chr22	38070865	38071862	2107	997	+	625.1008743726575	164.52855713025633
chr22	38073065	38073585	2108	520	+	545.6823206613773	95.9749916593162
chr22	38077485	38078005	2109	520	+	102.47555317584549	50.27261467868944
chr22	38082085	38082845	2110	760	+	263.87454942780215	562.1392368617092
chr22	38092685	38093205	2111	520	+	271.56021591599057	18.280950792250707
chr22	38127845	38128425	2112	580	+	61.485331905507294	114.25594245156691
chr22	38131045	38131565	2113	520	+	46.113998929130474	9.140475396125353
chr22	38138345	38138885	2114	540	+	30.742665952753647	13.710713094188028
chr22	38141905	38142490	2115	585	+	99.91366434644934	50.27261467868944
chr22	38145665	38146165	2116	500	+	10.247555317584547	68.55356547094014
chr22	38158465	38159005	2117	540	+	76.85666488188411	91.40475396125352
chr22	38173325	38173865	2118	540	+	194.70355103410643	13.710713094188028
chr22	38178645	38179165	2119	520	+	46.113998929130474	27.421426188376056
chr22	38187725	38188245	2120	520	+	94.78988668765707	13.710713094188028
chr22	38194105	38194605	2121	500	+	28.180777123357508	13.710713094188028
chr22	38198205	38198705	2122	500	+	35.86644361154592	297.065450374074
chr22	38199145	38199645	2123	500	+	497.00643290285063	470.7344829004557
chr22	38200863	38201363	2124	500	+	5.123777658792274	4.570237698062677
chr22	38202265	38203365	2125	1100	+	199.82732869289867	356.47854044888874
chr22	38203565	38204161	2126	596	+	481.6350999264738	150.8178440360683
chr22	38205945	38206445	2127	500	+	48.675887758526606	31.991663886438737
chr22	38213545	38214045	2128	500	+	117.84688615222231	63.98332777287747
chr22	38219138	38219638	2129	500	+	0.0	0.0
chr22	38240103	38240745	2130	642	+	1637.0469619841317	146.24760633800565
chr22	38243965	38244465	2131	500	+	23.056999464565237	132.53689324381762
chr22	38244545	38245628	2132	1083	+	338.1693254802901	722.0975562939028
chr22	38248185	38248705	2133	520	+	35.86644361154592	45.70237698062676
chr22	38259445	38259965	2134	520	+	71.73288722309184	22.85118849031338
chr22	38289405	38290005	2135	600	+	46.113998929130474	45.70237698062676
chr22	38300985	38301505	2136	520	+	217.76055049867165	525.5773352772078
chr22	38301904	38302405	2137	501	+	94.78988668765707	73.12380316900283
chr22	38309185	38309685	2138	500	+	79.41855371128025	45.70237698062676
chr22	38329845	38330365	2139	520	+	309.9885483569326	91.40475396125352
chr22	38347205	38347825	2140	620	+	48.675887758526606	13.710713094188028
chr22	38349385	38349926	2141	541	+	256.1888829396137	196.52022101669507
chr22	38361105	38361625	2142	520	+	46.113998929130474	9.140475396125353
chr22	38380289	38380789	2143	500	+	7.685666488188412	4.570237698062677
chr22	38387705	38388205	2144	500	+	30.742665952753647	9.140475396125353
chr22	38408645	38409145	2145	500	+	61.485331905507294	68.55356547094014
chr22	38419025	38419545	2146	520	+	35.86644361154592	4.570237698062677
chr22	38428765	38429265	2147	500	+	76.85666488188411	27.421426188376056
chr22	38430185	38431005	2148	820	+	286.93154889236735	393.04044203339015
chr22	38448205	38448705	2149	500	+	61.485331905507294	4.570237698062677
chr22	38452985	38453511	2150	526	+	215.1986616692755	306.2059257701993
chr22	38478920	38479420	2151	500	+	5.123777658792274	0.0
chr22	38493585	38494185	2152	600	+	76.85666488188411	9.140475396125353
chr22	38496685	38497225	2153	540	+	89.6661090288648	22.85118849031338
chr22	38499185	38499685	2154	500	+	25.618888293961373	9.140475396125353
chr22	38506426	38506926	2155	500	+	0.0	4.570237698062677
chr22	38510405	38510965	2156	560	+	30.742665952753647	13.710713094188028
chr22	38523245	38523745	2157	500	+	248.50321645142532	201.09045871475777
chr22	38539345	38539865	2158	520	+	148.58955210497595	91.40475396125352
chr22	38541665	38542185	2159	520	+	30.742665952753647	68.55356547094014
chr22	38543725	38544225	2160	500	+	43.552110099734335	18.280950792250707
chr22	38546465	38546985	2161	520	+	48.675887758526606	0.0
chr22	38558345	38558885	2162	540	+	40.99022127033819	100.54522935737889
chr22	38559705	38560225	2163	520	+	230.56999464565234	141.67736863994298
chr22	38573945	38574445	2164	500	+	64.04722073490342	127.96665554575495
chr22	38574965	38575525	2165	560	+	40.99022127033819	219.37140950700845
chr22	38576045	38576545	2166	500	+	430.397323338551	886.6261134241593
chr22	38576805	38577445	2167	640	+	46.113998929130474	2225.7057589565234
chr22	38577511	38578165	2168	654	+	999.1366434644935	804.3618348590311
chr22	38580725	38581225	2169	500	+	25.618888293961373	22.85118849031338
chr22	38589505	38590025	2170	520	+	110.16121966403391	13.710713094188028
chr22	38592945	38593445	2171	500	+	20.495110635169095	27.421426188376056
chr22	38597645	38598188	2172	543	+	353.5406584566669	91.40475396125352
chr22	38598365	38598865	2173	500	+	66.60910956429957	118.82618014962958
chr22	38599085	38599585	2174	500	+	20.495110635169095	73.12380316900283
chr22	38610585	38611165	2175	580	+	105.03744200524163	18.280950792250707
chr22	38636705	38637285	2176	580	+	97.35177551705321	269.6440241856979
chr22	38654905	38655425	2177	520	+	38.42833244094206	18.280950792250707
chr22	38662045	38662565	2178	520	+	122.97066381101459	164.52855713025633
chr22	38663065	38663585	2179	520	+	181.89410688712573	36.56190158450141
chr22	38668765	38669825	2180	1060	+	97.35177551705321	347.3380650527634
chr22	38671925	38672425	2181	500	+	56.361554246715016	31.991663886438737
chr22	38673185	38673705	2182	520	+	112.72310849343003	18.280950792250707
chr22	38674705	38675225	2183	520	+	53.79966541731888	27.421426188376056
chr22	38679025	38679525	2184	500	+	33.304554782149786	9.140475396125353
chr22	38680965	38681545	2185	580	+	207.51299518108712	50.27261467868944
chr22	38701505	38702585	2186	1080	+	94.78988668765707	27.421426188376056
chr22	38712305	38712805	2187	500	+	28.180777123357508	95.9749916593162
chr22	38713305	38713805	2188	500	+	30.742665952753647	91.40475396125352
chr22	38713839	38714705	2189	866	+	210.07488401048326	580.4201876539598
chr22	38715185	38715705	2190	520	+	56.361554246715016	109.68570475350423
chr22	38749045	38749545	2191	500	+	30.742665952753647	13.710713094188028
chr22	38765165	38765665	2192	500	+	10.247555317584547	4.570237698062677
chr22	38765725	38766265	2193	540	+	46.113998929130474	0.0
chr22	38766405	38767025	2194	620	+	64.04722073490342	9.140475396125353
chr22	38788805	38789305	2195	500	+	17.93322180577296	4.570237698062677
chr22	38790865	38791405	2196	540	+	92.22799785826095	41.13213928256408
chr22	38791965	38792465	2197	500	+	51.237776587922745	22.85118849031338
chr22	38793065	38793585	2198	520	+	48.675887758526606	31.991663886438737
chr22	38794277	38795405	2199	1128	+	143.46577444618367	82.26427856512817
chr22	38796205	38796705	2200	500	+	40.99022127033819	0.0
chr22	38799945	38800445	2201	500	+	38.42833244094206	4.570237698062677
chr22	38808245	38808765	2202	520	+	130.65633029920298	18.280950792250707
chr22	38839783	38840525	2203	742	+	64.04722073490342	27.421426188376056
chr22	38857485	38857985	2204	500	+	176.77032922833345	13.710713094188028
chr22	38859305	38859825	2205	520	+	279.24588240417893	13.710713094188028
chr22	38862785	38863405	2206	620	+	33.304554782149786	36.56190158450141
chr22	38863785	38864316	2207	531	+	43.552110099734335	242.22259799732186
chr22	38878065	38878565	2208	500	+	43.552110099734335	18.280950792250707
chr22	38886765	38887325	2209	560	+	46.113998929130474	36.56190158450141
chr22	38897745	38898285	2210	540	+	48.675887758526606	31.991663886438737
chr22	38900625	38901125	2211	500	+	151.15144093437212	333.6273519585754
chr22	38901645	38902825	2212	1180	+	684.0243174487687	1553.88081734131
chr22	38906325	38907145	2213	820	+	53.79966541731888	59.41309007481479
chr22	38908505	38909005	2214	500	+	12.809444146980686	36.56190158450141
chr22	38909025	38909545	2215	520	+	53.79966541731888	31.991663886438737
chr22	38910525	38911045	2216	520	+	389.40710206821285	178.23927022444437
chr22	38912865	38913445	2217	580	+	48.675887758526606	9.140475396125353
chr22	38920345	38920865	2218	520	+	58.923443076111155	27.421426188376056
chr22	38965951	38967345	2219	1394	+	397.09276855640127	493.585671390769
chr22	38968105	38968625	2220	520	+	81.98044254067638	4.570237698062677
chr22	38979485	38979985	2221	500	+	25.618888293961373	13.710713094188028
chr22	39002585	39003105	2222	520	+	71.73288722309184	9.140475396125353
chr22	39019305	39019805	2223	500	+	12.809444146980686	4.570237698062677
chr22	39028425	39028965	2224	540	+	46.113998929130474	9.140475396125353
chr22	39034665	39035165	2225	500	+	233.13188347504848	4.570237698062677
chr22	39051705	39053745	2226	2040	+	276.68399357478285	1069.4356213466663
chr22	39071725	39072225	2227	500	+	20.495110635169095	9.140475396125353
chr22	39076985	39077505	2228	520	+	58.923443076111155	82.26427856512817
chr22	39077645	39078203	2229	558	+	174.20844039893734	155.388081734131
chr22	39089985	39090505	2230	520	+	89.6661090288648	95.9749916593162
chr22	39092565	39093065	2231	500	+	128.09444146980684	59.41309007481479
chr22	39093325	39093825	2232	500	+	92.22799785826095	155.388081734131
chr22	39095325	39096709	2233	1384	+	120.40877498161845	498.15590908883166
chr22	39096805	39097765	2234	960	+	348.4168807978747	479.874958296581
chr22	39099105	39100405	2235	1300	+	69.17099839369571	82.26427856512817
chr22	39101325	39102056	2236	731	+	2233.9670592334314	191.9499833186324
chr22	39103305	39103845	2237	540	+	92.22799785826095	95.9749916593162
chr22	39106325	39106845	2238	520	+	40.99022127033819	18.280950792250707
chr22	39108405	39108925	2239	520	+	40.99022127033819	22.85118849031338
chr22	39109825	39110865	2240	1040	+	189.57977337531415	114.25594245156691
chr22	39112745	39113245	2241	500	+	35.86644361154592	45.70237698062676
chr22	39150225	39150765	2242	540	+	46.113998929130474	100.54522935737889
chr22	39151305	39152365	2243	1060	+	179.3322180577296	228.51188490313382
chr22	39164725	39165245	2244	520	+	53.79966541731888	4.570237698062677
chr22	39178345	39178865	2245	520	+	89.6661090288648	54.84285237675211
chr22	39181605	39182125	2246	520	+	489.3207664146622	397.6106797314528
chr22	39184305	39184825	2247	520	+	125.53255264041073	50.27261467868944
chr22	39188785	39189525	2248	740	+	66.60910956429957	141.67736863994298
chr22	39189911	39190505	2249	594	+	832.6138695537446	68.55356547094014
chr22	39198665	39199165	2250	500	+	48.675887758526606	18.280950792250707
chr22	39220445	39220965	2251	520	+	48.675887758526606	4.570237698062677
chr22	39227105	39227645	2252	540	+	43.552110099734335	0.0
chr22	39233445	39233985	2253	540	+	46.113998929130474	13.710713094188028
chr22	39239185	39239705	2254	520	+	28.180777123357508	9.140475396125353
chr22	39239767	39240745	2255	978	+	97.35177551705321	27.421426188376056
chr22	39242885	39243405	2256	520	+	330.48365899210165	91.40475396125352
chr22	39243465	39243965	2257	500	+	28.180777123357508	86.83451626319085
chr22	39247405	39247905	2258	500	+	56.361554246715016	0.0
chr22	39249845	39250345	2259	500	+	20.495110635169095	9.140475396125353
chr22	39264805	39265305	2260	500	+	48.675887758526606	41.13213928256408
chr22	39266165	39266665	2261	500	+	107.59933083463775	13.710713094188028
chr22	39268085	39268665	2262	580	+	153.71332976376823	82.26427856512817
chr22	39268845	39269345	2263	500	+	53.79966541731888	82.26427856512817
chr22	39269965	39270465	2264	500	+	61.485331905507294	13.710713094188028
chr22	39317745	39318265	2265	520	+	74.29477605248798	9.140475396125353
chr22	39319745	39320265	2266	520	+	215.1986616692755	18.280950792250707
chr22	39320305	39320845	2267	540	+	66.60910956429957	27.421426188376056
chr22	39339105	39339645	2268	540	+	43.552110099734335	13.710713094188028
chr22	39353276	39353776	2269	500	+	7.685666488188412	4.570237698062677
chr22	39361785	39362305	2270	520	+	61.485331905507294	4.570237698062677
chr22	39363705	39364205	2271	500	+	76.85666488188411	9.140475396125353
chr22	39369445	39369945	2272	500	+	30.742665952753647	4.570237698062677
chr22	39377205	39377745	2273	540	+	43.552110099734335	77.6940408670655
chr22	39378105	39378653	2274	548	+	348.4168807978747	223.94164720507112
chr22	39380185	39380685	2275	500	+	356.10254728606304	50.27261467868944
chr22	39393975	39394475	2276	500	+	0.0	0.0
chr22	39399025	39399565	2277	540	+	61.485331905507294	4.570237698062677
chr22	39408465	39409385	2278	920	+	204.95110635169098	182.80950792250704
chr22	39409945	39410514	2279	569	+	338.1693254802901	223.94164720507112
chr22	39415905	39416425	2280	520	+	43.552110099734335	18.280950792250707
chr22	39416865	39417367	2281	502	+	38.42833244094206	9.140475396125353
chr22	39434765	39435265	2282	500	+	28.180777123357508	0.0
chr22	39436422	39437205	2283	783	+	112.72310849343003	18.280950792250707
chr22	39472759	39473485	2284	726	+	94.78988668765707	18.280950792250707
chr22	39492978	39493485	2285	507	+	140.90388561678753	13.710713094188028
chr22	39504285	39504785	2286	500	+	33.304554782149786	0.0
chr22	39506825	39507345	2287	520	+	81.98044254067638	13.710713094188028
chr22	39510165	39510665	2288	500	+	33.304554782149786	0.0
chr22	39511085	39511585	2289	500	+	30.742665952753647	0.0
chr22	39513785	39514305	2290	520	+	64.04722073490342	13.710713094188028
chr22	39517885	39518385	2291	500	+	20.495110635169095	9.140475396125353
chr22	39526245	39526805	2292	560	+	38.42833244094206	31.991663886438737
chr22	39527185	39527685	2293	500	+	28.180777123357508	13.710713094188028
chr22	39540885	39541385	2294	500	+	28.180777123357508	36.56190158450141
chr22	39541565	39542145	2295	580	+	43.552110099734335	59.41309007481479
chr22	39548365	39549105	2296	740	+	166.52277391074892	82.26427856512817
chr22	39566725	39567225	2297	500	+	84.54233137007253	13.710713094188028
chr22	39575385	39575965	2298	580	+	66.60910956429957	22.85118849031338
chr22	39579885	39580405	2299	520	+	84.54233137007253	0.0
chr22	39584745	39585345	2300	600	+	56.361554246715016	9.140475396125353
chr22	39601265	39601765	2301	500	+	46.113998929130474	18.280950792250707
chr22	39608605	39609165	2302	560	+	207.51299518108712	50.27261467868944
chr22	39615345	39615865	2303	520	+	38.42833244094206	4.570237698062677
chr22	39617425	39617925	2304	500	+	33.304554782149786	31.991663886438737
chr22	39632365	39632865	2305	500	+	163.96088508135276	18.280950792250707
chr22	39633345	39633845	2306	500	+	35.86644361154592	0.0
chr22	39636765	39637265	2307	500	+	71.73288722309184	31.991663886438737
chr22	39640725	39641310	2308	585	+	81.98044254067638	31.991663886438737
chr22	39641605	39642105	2309	500	+	33.304554782149786	27.421426188376056
chr22	39642605	39643185	2310	580	+	192.1416622047103	22.85118849031338
chr22	39646185	39646685	2311	500	+	30.742665952753647	22.85118849031338
chr22	39649345	39649865	2312	520	+	89.6661090288648	45.70237698062676
chr22	39660945	39661485	2313	540	+	53.79966541731888	27.421426188376056
chr22	39662265	39663005	2314	740	+	97.35177551705321	50.27261467868944
chr22	39670145	39670645	2315	500	+	381.72143558002443	31.991663886438737
chr22	39673245	39673785	2316	540	+	69.17099839369571	45.70237698062676
chr22	39677145	39678105	2317	960	+	64.04722073490342	205.66069641282044
chr22	39678905	39679405	2318	500	+	99.91366434644934	612.4118515403986
chr22	39679465	39679985	2319	520	+	486.7588775852661	274.21426188376057
chr22	39680945	39681445	2320	500	+	28.180777123357508	50.27261467868944
chr22	39686625	39687345	2321	720	+	48.675887758526606	86.83451626319085
chr22	39688545	39689065	2322	520	+	481.6350999264738	255.9333110915099
chr22	39695725	39696665	2323	940	+	115.28499732282617	59.41309007481479
chr22	39702625	39703145	2324	520	+	48.675887758526606	41.13213928256408
chr22	39704685	39705245	2325	560	+	81.98044254067638	95.9749916593162
chr22	39706965	39708165	2326	1200	+	594.3582084199038	159.95831943219366
chr22	39712265	39712805	2327	540	+	64.04722073490342	169.09879482831903
chr22	39715065	39716025	2328	960	+	430.397323338551	1083.1463344408542
chr22	39716065	39717025	2329	960	+	153.71332976376823	740.3785070861535
chr22	39730245	39730745	2330	500	+	38.42833244094206	9.140475396125353
chr22	39739485	39740505	2331	1020	+	238.25566113384076	59.41309007481479
chr22	39745703	39746203	2332	500	+	2.561888829396137	18.280950792250707
chr22	39759665	39760205	2333	540	+	89.6661090288648	73.12380316900283
chr22	39777005	39777505	2334	500	+	20.495110635169095	18.280950792250707
chr22	39780665	39781165	2335	500	+	35.86644361154592	27.421426188376056
chr22	39784145	39784645	2336	500	+	228.0081058162562	9.140475396125353
chr22	39792325	39792825	2337	500	+	74.29477605248798	36.56190158450141
chr22	39795485	39796008	2338	523	+	274.1221047453867	159.95831943219366
chr22	39818625	39819125	2339	500	+	499.5683217322468	95.9749916593162
chr22	39827914	39828414	2340	500	+	0.0	0.0
chr22	39833105	39833645	2341	540	+	81.98044254067638	50.27261467868944
chr22	39835025	39835545	2342	520	+	161.39899625195665	77.6940408670655
chr22	39842165	39842745	2343	580	+	38.42833244094206	45.70237698062676
chr22	39844065	39844645	2344	580	+	64.04722073490342	13.710713094188028
chr22	39847865	39849165	2345	1300	+	517.5015435380196	246.7928356953845
chr22	39849725	39850265	2346	540	+	143.46577444618367	41.13213928256408
chr22	39850385	39850885	2347	500	+	30.742665952753647	22.85118849031338
chr22	39858325	39858845	2348	520	+	207.51299518108712	91.40475396125352
chr22	39860885	39861385	2349	500	+	368.9119914330438	59.41309007481479
chr22	39862545	39863045	2350	500	+	74.29477605248798	41.13213928256408
chr22	39865865	39866365	2351	500	+	17.93322180577296	50.27261467868944
chr22	39867745	39868265	2352	520	+	115.28499732282617	223.94164720507112
chr22	39868845	39869705	2353	860	+	853.1089801889136	872.9154003299711
chr22	39870645	39871165	2354	520	+	76.85666488188411	54.84285237675211
chr22	39872577	39873105	2355	528	+	51.237776587922745	22.85118849031338
chr22	39882745	39883505	2356	760	+	199.82732869289867	54.84285237675211
chr22	39884765	39885725	2357	960	+	217.76055049867165	191.9499833186324
chr22	39886065	39886585	2358	520	+	220.32243932806782	54.84285237675211
chr22	39889265	39889765	2359	500	+	38.42833244094206	18.280950792250707
chr22	39891345	39891905	2360	560	+	94.78988668765707	45.70237698062676
chr22	39892285	39892825	2361	540	+	84.54233137007253	159.95831943219366
chr22	39896865	39897425	2362	560	+	140.90388561678753	109.68570475350423
chr22	39897984	39898525	2363	541	+	476.5113222676815	109.68570475350423
chr22	39903745	39904285	2364	540	+	35.86644361154592	50.27261467868944
chr22	39904305	39904805	2365	500	+	143.46577444618367	45.70237698062676
chr22	39910245	39910745	2366	500	+	33.304554782149786	36.56190158450141
chr22	39914385	39914885	2367	500	+	81.98044254067638	63.98332777287747
chr22	39915925	39916818	2368	893	+	607.1676525668845	1284.2367931556118
chr22	39916905	39917405	2369	500	+	64.04722073490342	342.7678273547007
chr22	39918685	39919345	2370	660	+	71.73288722309184	187.37974562056974
chr22	39920545	39921045	2371	500	+	76.85666488188411	18.280950792250707
chr22	39921245	39921745	2372	500	+	38.42833244094206	22.85118849031338
chr22	39922785	39923285	2373	500	+	40.99022127033819	31.991663886438737
chr22	39925105	39925625	2374	520	+	133.21821912859915	18.280950792250707
chr22	39926665	39927185	2375	520	+	179.3322180577296	77.6940408670655
chr22	39928610	39929145	2376	535	+	1232.268526939542	118.82618014962958
chr22	39930645	39931185	2377	540	+	61.485331905507294	50.27261467868944
chr22	39937025	39937525	2378	500	+	28.180777123357508	4.570237698062677
chr22	39939045	39939585	2379	540	+	56.361554246715016	13.710713094188028
chr22	39941705	39942205	2380	500	+	35.86644361154592	9.140475396125353
chr22	39953205	39953705	2381	500	+	30.742665952753647	4.570237698062677
chr22	39966507	39967007	2382	500	+	0.0	4.570237698062677
chr22	39970685	39971205	2383	520	+	120.40877498161845	59.41309007481479
chr22	39971265	39971765	2384	500	+	35.86644361154592	45.70237698062676
chr22	39994105	39994625	2385	520	+	40.99022127033819	4.570237698062677
chr22	40002625	40003145	2386	520	+	56.361554246715016	9.140475396125353
chr22	40018825	40019385	2387	560	+	56.361554246715016	22.85118849031338
chr22	40021445	40021965	2388	520	+	94.78988668765707	95.9749916593162
chr22	40022105	40022605	2389	500	+	222.88432815746395	214.80117180894578
chr22	40023805	40024305	2390	500	+	25.618888293961373	9.140475396125353
chr22	40030725	40031245	2391	520	+	130.65633029920298	100.54522935737889
chr22	40034745	40035365	2392	620	+	56.361554246715016	9.140475396125353
chr22	40050885	40051405	2393	520	+	71.73288722309184	27.421426188376056
chr22	40058225	40058725	2394	500	+	20.495110635169095	9.140475396125353
chr22	40060325	40060845	2395	520	+	112.72310849343003	22.85118849031338
chr22	40098005	40098525	2396	520	+	66.60910956429957	18.280950792250707
chr22	40115845	40116345	2397	500	+	69.17099839369571	22.85118849031338
chr22	40119765	40120265	2398	500	+	384.2833244094206	191.9499833186324
chr22	40120305	40120825	2399	520	+	87.10422019946867	201.09045871475777
chr22	40138985	40139485	2400	500	+	30.742665952753647	4.570237698062677
chr22	40139905	40140425	2401	520	+	53.79966541731888	0.0
chr22	40144785	40145285	2402	500	+	23.056999464565237	50.27261467868944
chr22	40147045	40147565	2403	520	+	215.1986616692755	22.85118849031338
chr22	40151085	40151605	2404	520	+	53.79966541731888	9.140475396125353
chr22	40161625	40162125	2405	500	+	105.03744200524163	27.421426188376056
chr22	40162525	40163025	2406	500	+	30.742665952753647	13.710713094188028
chr22	40169945	40170445	2407	500	+	240.8175499632369	155.388081734131
chr22	40176305	40176825	2408	520	+	33.304554782149786	0.0
chr22	40181165	40181725	2409	560	+	58.923443076111155	0.0
chr22	40185845	40186345	2410	500	+	46.113998929130474	22.85118849031338
chr22	40197105	40197665	2411	560	+	128.09444146980684	13.710713094188028
chr22	40211765	40212265	2412	500	+	38.42833244094206	13.710713094188028
chr22	40214005	40214505	2413	500	+	179.3322180577296	196.52022101669507
chr22	40216205	40216725	2414	520	+	115.28499732282617	27.421426188376056
chr22	40216785	40217285	2415	500	+	58.923443076111155	27.421426188376056
chr22	40226885	40227485	2416	600	+	69.17099839369571	132.53689324381762
chr22	40228585	40229125	2417	540	+	573.8630977847347	626.1225646345866
chr22	40235185	40235685	2418	500	+	107.59933083463775	86.83451626319085
chr22	40236005	40236505	2419	500	+	566.1774312965463	41.13213928256408
chr22	40240965	40241545	2420	580	+	64.04722073490342	59.41309007481479
chr22	40247425	40247945	2421	520	+	56.361554246715016	27.421426188376056
chr22	40251505	40252085	2422	580	+	53.79966541731888	9.140475396125353
chr22	40252505	40253005	2423	500	+	169.08466274014506	22.85118849031338
chr22	40255805	40256805	2424	1000	+	107.59933083463775	45.70237698062676
chr22	40269605	40270405	2425	800	+	48.675887758526606	9.140475396125353
chr22	40273225	40273805	2426	580	+	66.60910956429957	59.41309007481479
chr22	40279225	40279805	2427	580	+	128.09444146980684	54.84285237675211
chr22	40289544	40290044	2428	500	+	2.561888829396137	4.570237698062677
chr22	40294965	40295465	2429	500	+	43.552110099734335	0.0
chr22	40296805	40297345	2430	540	+	48.675887758526606	36.56190158450141
chr22	40304665	40305165	2431	500	+	64.04722073490342	50.27261467868944
chr22	40309725	40310365	2432	640	+	51.237776587922745	13.710713094188028
chr22	40311425	40311925	2433	500	+	38.42833244094206	31.991663886438737
chr22	40313945	40314545	2434	600	+	79.41855371128025	73.12380316900283
chr22	40316025	40316605	2435	580	+	425.27354567975874	205.66069641282044
chr22	40322344	40322905	2436	561	+	20.495110635169095	31.991663886438737
chr22	40326745	40327265	2437	520	+	48.675887758526606	18.280950792250707
chr22	40328705	40329305	2438	600	+	51.237776587922745	13.710713094188028
chr22	40334445	40334945	2439	500	+	46.113998929130474	63.98332777287747
chr22	40336665	40337205	2440	540	+	46.113998929130474	36.56190158450141
chr22	40342465	40342985	2441	520	+	625.1008743726575	607.841613842336
chr22	40345545	40346485	2442	940	+	117.84688615222231	246.7928356953845
chr22	40348865	40349365	2443	500	+	20.495110635169095	41.13213928256408
chr22	40349745	40350305	2444	560	+	58.923443076111155	22.85118849031338
chr22	40352865	40353365	2445	500	+	43.552110099734335	0.0
chr22	40354805	40355325	2446	520	+	286.93154889236735	146.24760633800565
chr22	40355485	40356005	2447	520	+	120.40877498161845	191.9499833186324
chr22	40357325	40357825	2448	500	+	617.415207884469	671.8249416152134
chr22	40361685	40362185	2449	500	+	473.9494334382854	169.09879482831903
chr22	40362405	40362905	2450	500	+	15.371332976376824	201.09045871475777
chr22	40363425	40363925	2451	500	+	94.78988668765707	50.27261467868944
chr22	40379985	40380505	2452	520	+	130.65633029920298	45.70237698062676
chr22	40384485	40384985	2453	500	+	84.54233137007253	123.39641784769225
chr22	40386625	40387125	2454	500	+	33.304554782149786	18.280950792250707
chr22	40389985	40390505	2455	520	+	71.73288722309184	9.140475396125353
chr22	40390702	40391202	2456	500	+	5.123777658792274	4.570237698062677
chr22	40395245	40395765	2457	520	+	783.937981795218	109.68570475350423
chr22	40397045	40397585	2458	540	+	61.485331905507294	9.140475396125353
chr22	40398125	40398625	2459	500	+	115.28499732282617	18.280950792250707
chr22	40405365	40405885	2460	520	+	30.742665952753647	9.140475396125353
chr22	40410785	40411285	2461	500	+	35.86644361154592	31.991663886438737
chr22	40411525	40412065	2462	540	+	53.79966541731888	22.85118849031338
chr22	40420665	40421245	2463	580	+	99.91366434644934	27.421426188376056
chr22	40424345	40424845	2464	500	+	25.618888293961373	18.280950792250707
chr22	40428085	40428585	2465	500	+	7.685666488188412	0.0
chr22	40432585	40433105	2466	520	+	107.59933083463775	9.140475396125353
chr22	40435365	40435885	2467	520	+	56.361554246715016	13.710713094188028
chr22	40436865	40437405	2468	540	+	430.397323338551	82.26427856512817
chr22	40438305	40438805	2469	500	+	92.22799785826095	73.12380316900283
chr22	40439265	40439765	2470	500	+	30.742665952753647	191.9499833186324
chr22	40440005	40440925	2471	920	+	1483.3336322203634	552.9987614655838
chr22	40441265	40441825	2472	560	+	51.237776587922745	109.68570475350423
chr22	40447265	40447785	2473	520	+	215.1986616692755	22.85118849031338
chr22	40451505	40452025	2474	520	+	271.56021591599057	50.27261467868944
chr22	40453605	40454105	2475	500	+	69.17099839369571	13.710713094188028
chr22	40454205	40454705	2476	500	+	66.60910956429957	22.85118849031338
chr22	40472665	40473485	2477	820	+	138.34199678739142	54.84285237675211
chr22	40476385	40476885	2478	500	+	35.86644361154592	27.421426188376056
chr22	40477525	40478045	2479	520	+	125.53255264041073	36.56190158450141
chr22	40480225	40480825	2480	600	+	84.54233137007253	41.13213928256408
chr22	40487805	40488305	2481	500	+	56.361554246715016	9.140475396125353
chr22	40519325	40519865	2482	540	+	43.552110099734335	13.710713094188028
chr22	40551965	40552525	2483	560	+	489.3207664146622	169.09879482831903
chr22	40553225	40553725	2484	500	+	33.304554782149786	22.85118849031338
chr22	40561505	40562005	2485	500	+	87.10422019946867	4.570237698062677
chr22	40571585	40572105	2486	520	+	69.17099839369571	246.7928356953845
chr22	40572985	40573505	2487	520	+	361.2263249448553	420.46186822176617
chr22	40573625	40574178	2488	553	+	625.1008743726575	319.9166388643873
chr22	40574925	40575525	2489	600	+	69.17099839369571	415.89163052370355
chr22	40576025	40576585	2490	560	+	58.923443076111155	73.12380316900283
chr22	40576905	40577405	2491	500	+	30.742665952753647	82.26427856512817
chr22	40578185	40578685	2492	500	+	28.180777123357508	22.85118849031338
chr22	40578925	40579565	2493	640	+	84.54233137007253	159.95831943219366
chr22	40580345	40580845	2494	500	+	28.180777123357508	27.421426188376056
chr22	40581825	40582345	2495	520	+	81.98044254067638	54.84285237675211
chr22	40583345	40583925	2496	580	+	115.28499732282617	118.82618014962958
chr22	40584225	40585345	2497	1120	+	89.6661090288648	82.26427856512817
chr22	40586005	40586945	2498	940	+	420.1497680209665	159.95831943219366
chr22	40589485	40590085	2499	600	+	51.237776587922745	31.991663886438737
chr22	40592505	40593105	2500	600	+	71.73288722309184	13.710713094188028
chr22	40598445	40598945	2501	500	+	320.23610367451715	68.55356547094014
chr22	40606705	40607205	2502	500	+	23.056999464565237	18.280950792250707
chr22	40636145	40636645	2503	500	+	220.32243932806782	4.570237698062677
chr22	40651945	40652445	2504	500	+	71.73288722309184	18.280950792250707
chr22	40659145	40659665	2505	520	+	105.03744200524163	18.280950792250707
chr22	40673425	40673925	2506	500	+	25.618888293961373	9.140475396125353
chr22	40683665	40684165	2507	500	+	23.056999464565237	31.991663886438737
chr22	40715285	40716205	2508	920	+	97.35177551705321	18.280950792250707
chr22	40716665	40717165	2509	500	+	25.618888293961373	27.421426188376056
chr22	40718065	40718565	2510	500	+	289.4934377217635	36.56190158450141
chr22	40725005	40725505	2511	500	+	561.053653637754	41.13213928256408
chr22	40728145	40729245	2512	1100	+	117.84688615222231	54.84285237675211
chr22	40738105	40738765	2513	660	+	61.485331905507294	59.41309007481479
chr22	40741225	40741725	2514	500	+	15.371332976376824	0.0
chr22	40742205	40743045	2515	840	+	258.7507717690098	292.4952126760113
chr22	40743965	40744525	2516	560	+	89.6661090288648	41.13213928256408
chr22	40766305	40766845	2517	540	+	245.94132762202918	77.6940408670655
chr22	40766925	40767785	2518	860	+	58.923443076111155	105.11546705544154
chr22	40768545	40769125	2519	580	+	40.99022127033819	18.280950792250707
chr22	40775205	40775725	2520	520	+	38.42833244094206	9.140475396125353
chr22	40779325	40779825	2521	500	+	28.180777123357508	54.84285237675211
chr22	40779865	40780365	2522	500	+	215.1986616692755	36.56190158450141
chr22	40781405	40781985	2523	580	+	48.675887758526606	31.991663886438737
chr22	40784145	40784705	2524	560	+	138.34199678739142	41.13213928256408
chr22	40795145	40795665	2525	520	+	56.361554246715016	22.85118849031338
chr22	40796025	40796585	2526	560	+	51.237776587922745	9.140475396125353
chr22	40832625	40833125	2527	500	+	653.281651496015	114.25594245156691
chr22	40853045	40853545	2528	500	+	15.371332976376824	4.570237698062677
chr22	40858445	40858945	2529	500	+	38.42833244094206	73.12380316900283
chr22	40859225	40859765	2530	540	+	166.52277391074892	191.9499833186324
chr22	40860685	40861225	2531	540	+	135.78010795799528	77.6940408670655
chr22	40861805	40862305	2532	500	+	30.742665952753647	13.710713094188028
chr22	40865085	40865605	2533	520	+	163.96088508135276	36.56190158450141
chr22	40872245	40872765	2534	520	+	99.91366434644934	36.56190158450141
chr22	40873845	40874385	2535	540	+	53.79966541731888	9.140475396125353
chr22	40877825	40878365	2536	540	+	25.618888293961373	0.0
chr22	40883625	40884125	2537	500	+	48.675887758526606	0.0
chr22	40888165	40888665	2538	500	+	30.742665952753647	4.570237698062677
chr22	40895145	40895665	2539	520	+	261.31266059840596	9.140475396125353
chr22	40908005	40908505	2540	500	+	5.123777658792274	4.570237698062677
chr22	40917553	40918053	2541	500	+	0.0	4.570237698062677
chr22	40921205	40921745	2542	540	+	61.485331905507294	9.140475396125353
chr22	40923885	40924425	2543	540	+	122.97066381101459	31.991663886438737
chr22	40928245	40928745	2544	500	+	30.742665952753647	9.140475396125353
chr22	40929605	40930125	2545	520	+	130.65633029920298	18.280950792250707
chr22	40930865	40931405	2546	540	+	51.237776587922745	27.421426188376056
chr22	40947965	40948465	2547	500	+	438.0829898267395	50.27261467868944
chr22	40948685	40949185	2548	500	+	12.809444146980686	13.710713094188028
chr22	40956505	40957025	2549	520	+	261.31266059840596	31.991663886438737
chr22	40963865	40964405	2550	540	+	58.923443076111155	4.570237698062677
chr22	40989865	40990385	2551	520	+	143.46577444618367	18.280950792250707
chr22	40991685	40992325	2552	640	+	30.742665952753647	13.710713094188028
chr22	41006265	41006805	2553	540	+	89.6661090288648	0.0
chr22	41008105	41008665	2554	560	+	120.40877498161845	31.991663886438737
chr22	41009125	41009745	2555	620	+	33.304554782149786	13.710713094188028
chr22	41012085	41012585	2556	500	+	33.304554782149786	4.570237698062677
chr22	41016405	41016925	2557	520	+	120.40877498161845	63.98332777287747
chr22	41017725	41018225	2558	500	+	199.82732869289867	31.991663886438737
chr22	41022125	41022665	2559	540	+	48.675887758526606	4.570237698062677
chr22	41024585	41025125	2560	540	+	138.34199678739142	41.13213928256408
chr22	41027965	41028465	2561	500	+	23.056999464565237	22.85118849031338
chr22	41030385	41030885	2562	500	+	79.41855371128025	22.85118849031338
chr22	41032473	41033525	2563	1052	+	999.1366434644935	466.164245202393
chr22	41033585	41034105	2564	520	+	38.42833244094206	9.140475396125353
chr22	41036505	41037005	2565	500	+	46.113998929130474	4.570237698062677
chr22	41037185	41037705	2566	520	+	184.4559957165219	36.56190158450141
chr22	41040565	41041105	2567	540	+	171.6465515695412	68.55356547094014
chr22	41042205	41042725	2568	520	+	202.38921752229484	41.13213928256408
chr22	41047545	41048445	2569	900	+	891.5373126298558	1096.8570475350423
chr22	41050565	41051085	2570	520	+	163.96088508135276	77.6940408670655
chr22	41062285	41062805	2571	520	+	51.237776587922745	9.140475396125353
chr22	41064025	41064585	2572	560	+	58.923443076111155	36.56190158450141
chr22	41064865	41065385	2573	520	+	105.03744200524163	50.27261467868944
chr22	41068525	41069145	2574	620	+	58.923443076111155	9.140475396125353
chr22	41074931	41075431	2575	500	+	7.685666488188412	9.140475396125353
chr22	41078985	41079505	2576	520	+	222.88432815746395	9.140475396125353
chr22	41085805	41086305	2577	500	+	35.86644361154592	4.570237698062677
chr22	41105685	41106185	2578	500	+	128.09444146980684	45.70237698062676
chr22	41107505	41108045	2579	540	+	466.26376695009697	63.98332777287747
chr22	41117185	41117705	2580	520	+	33.304554782149786	4.570237698062677
chr22	41122445	41122945	2581	500	+	43.552110099734335	0.0
chr22	41124725	41125285	2582	560	+	61.485331905507294	22.85118849031338
chr22	41139665	41140165	2583	500	+	56.361554246715016	27.421426188376056
chr22	41194905	41195405	2584	500	+	17.93322180577296	18.280950792250707
chr22	41196265	41196825	2585	560	+	53.79966541731888	18.280950792250707
chr22	41209925	41210425	2586	500	+	568.7393201259424	146.24760633800565
chr22	41213025	41213545	2587	520	+	102.47555317584549	251.3630733934472
chr22	41214005	41214505	2588	500	+	46.113998929130474	159.95831943219366
chr22	41214665	41215725	2589	1060	+	228.0081058162562	635.263040030712
chr22	41216525	41217125	2590	600	+	30.742665952753647	9.140475396125353
chr22	41249445	41250385	2591	940	+	69.17099839369571	109.68570475350423
chr22	41250905	41251405	2592	500	+	25.618888293961373	77.6940408670655
chr22	41251625	41252345	2593	720	+	81.98044254067638	365.6190158450141
chr22	41252485	41253334	2594	849	+	543.1204318319811	708.3868431997148
chr22	41257880	41258380	2595	500	+	12.809444146980686	22.85118849031338
chr22	41294925	41295525	2596	600	+	94.78988668765707	45.70237698062676
chr22	41298605	41299425	2597	820	+	102.47555317584549	13.710713094188028
chr22	41318665	41319185	2598	520	+	48.675887758526606	9.140475396125353
chr22	41324605	41325125	2599	520	+	169.08466274014506	9.140475396125353
chr22	41346805	41347945	2600	1140	+	924.8418674120055	292.4952126760113
chr22	41349325	41349885	2601	560	+	46.113998929130474	95.9749916593162
chr22	41350065	41350565	2602	500	+	12.809444146980686	41.13213928256408
chr22	41360525	41361025	2603	500	+	58.923443076111155	54.84285237675211
chr22	41361845	41362365	2604	520	+	140.90388561678753	169.09879482831903
chr22	41362665	41363205	2605	540	+	102.47555317584549	59.41309007481479
chr22	41372945	41373525	2606	580	+	46.113998929130474	22.85118849031338
chr22	41417765	41418285	2607	520	+	74.29477605248798	68.55356547094014
chr22	41418385	41419205	2608	820	+	112.72310849343003	50.27261467868944
chr22	41441305	41441805	2609	500	+	28.180777123357508	0.0
chr22	41444725	41445265	2610	540	+	107.59933083463775	31.991663886438737
chr22	41486545	41487045	2611	500	+	23.056999464565237	27.421426188376056
chr22	41487345	41487865	2612	520	+	599.4819860786962	219.37140950700845
chr22	41488325	41488863	2613	538	+	94.78988668765707	118.82618014962958
chr22	41489005	41489505	2614	500	+	46.113998929130474	91.40475396125352
chr22	41489985	41490505	2615	520	+	53.79966541731888	36.56190158450141
chr22	41582625	41583625	2616	1000	+	422.71165685036266	31.991663886438737
chr22	41592805	41594065	2617	1260	+	89.6661090288648	50.27261467868944
chr22	41600985	41601562	2618	577	+	497.00643290285063	315.34640116632465
chr22	41613645	41614145	2619	500	+	28.180777123357508	68.55356547094014
chr22	41636685	41637185	2620	500	+	0.0	4.570237698062677
chr22	41681305	41682705	2621	1400	+	1052.9363088818125	539.2880483713958
chr22	41684205	41684725	2622	520	+	51.237776587922745	86.83451626319085
chr22	41697245	41697785	2623	540	+	79.41855371128025	59.41309007481479
chr22	41699085	41699725	2624	640	+	122.97066381101459	365.6190158450141
chr22	41700305	41700805	2625	500	+	163.96088508135276	100.54522935737889
chr22	41703705	41704965	2626	1260	+	122.97066381101459	187.37974562056974
chr22	41707465	41707965	2627	500	+	156.27521859316437	68.55356547094014
chr22	41746105	41746605	2628	500	+	74.29477605248798	59.41309007481479
chr22	41750065	41750645	2629	580	+	35.86644361154592	86.83451626319085
chr22	41763045	41763565	2630	520	+	502.1302105616429	18.280950792250707
chr22	41776265	41776805	2631	540	+	169.08466274014506	306.2059257701993
chr22	41776825	41778645	2632	1820	+	1060.6219753700009	562.1392368617092
chr22	41799705	41800205	2633	500	+	89.6661090288648	36.56190158450141
chr22	41809385	41810205	2634	820	+	122.97066381101459	429.60234361789156
chr22	41839045	41839545	2635	500	+	25.618888293961373	4.570237698062677
chr22	41840265	41840765	2636	500	+	668.6529844723918	169.09879482831903
chr22	41841065	41841625	2637	560	+	107.59933083463775	214.80117180894578
chr22	41842625	41843277	2638	652	+	240.8175499632369	447.88329441014224
chr22	41843385	41843945	2639	560	+	56.361554246715016	452.45353210820497
chr22	41844325	41844845	2640	520	+	850.5470913595175	91.40475396125352
chr22	41864458	41865785	2641	1327	+	1019.6317540996625	1832.665316923133
chr22	41878225	41878805	2642	580	+	76.85666488188411	68.55356547094014
chr22	41883145	41883645	2643	500	+	48.675887758526606	50.27261467868944
chr22	41901725	41902305	2644	580	+	51.237776587922745	18.280950792250707
chr22	41908745	41909265	2645	520	+	110.16121966403391	164.52855713025633
chr22	41919505	41920045	2646	540	+	481.6350999264738	447.88329441014224
chr22	41922545	41923045	2647	500	+	46.113998929130474	59.41309007481479
chr22	41929145	41929645	2648	500	+	23.056999464565237	36.56190158450141
chr22	41930305	41930805	2649	500	+	12.809444146980686	9.140475396125353
chr22	41931145	41931725	2650	580	+	48.675887758526606	13.710713094188028
chr22	41935765	41936345	2651	580	+	376.59765792123216	159.95831943219366
chr22	41939685	41940185	2652	500	+	46.113998929130474	201.09045871475777
chr22	41940243	41940845	2653	602	+	678.9005397899764	68.55356547094014
chr22	41949785	41950345	2654	560	+	66.60910956429957	0.0
chr22	41951225	41951725	2655	500	+	17.93322180577296	18.280950792250707
chr22	41956637	41957263	2656	626	+	10.247555317584547	27.421426188376056
chr22	41958965	41959825	2657	860	+	161.39899625195665	219.37140950700845
chr22	41961505	41962045	2658	540	+	371.47388026243993	228.51188490313382
chr22	41969305	41969805	2659	500	+	17.93322180577296	27.421426188376056
chr22	41972785	41973365	2660	580	+	51.237776587922745	22.85118849031338
chr22	41985621	41986265	2661	644	+	960.7083110235515	100.54522935737889
chr22	41987985	41988485	2662	500	+	43.552110099734335	36.56190158450141
chr22	41993525	41994505	2663	980	+	140.90388561678753	196.52022101669507
chr22	41999765	42000325	2664	560	+	520.0634323674158	63.98332777287747
chr22	42004565	42005145	2665	580	+	30.742665952753647	22.85118849031338
chr22	42014885	42015405	2666	520	+	56.361554246715016	13.710713094188028
chr22	42016811	42017945	2667	1134	+	906.9086456062325	1201.9725145904838
chr22	42052505	42053045	2668	540	+	33.304554782149786	13.710713094188028
chr22	42062625	42063145	2669	520	+	222.88432815746395	351.9083027508261
chr22	42063325	42063845	2670	520	+	76.85666488188411	173.6690325263817
chr22	42078265	42078765	2671	500	+	399.65465738579735	365.6190158450141
chr22	42084645	42085163	2672	518	+	184.4559957165219	278.78449958182324
chr22	42086296	42086796	2673	500	+	15.371332976376824	22.85118849031338
chr22	42093005	42093545	2674	540	+	133.21821912859915	68.55356547094014
chr22	42095267	42095767	2675	500	+	2.561888829396137	0.0
chr22	42108925	42109425	2676	500	+	48.675887758526606	0.0
chr22	42121465	42121965	2677	500	+	343.2931031390824	118.82618014962958
chr22	42122025	42122525	2678	500	+	25.618888293961373	0.0
chr22	42132385	42132885	2679	500	+	69.17099839369571	4.570237698062677
chr22	42142505	42143045	2680	540	+	125.53255264041073	18.280950792250707
chr22	42154145	42154665	2681	520	+	53.79966541731888	9.140475396125353
chr22	42158985	42159525	2682	540	+	71.73288722309184	4.570237698062677
chr22	42177045	42177605	2683	560	+	120.40877498161845	4.570237698062677
chr22	42195785	42196285	2684	500	+	25.618888293961373	260.5035487895725
chr22	42196365	42196875	2685	510	+	194.70355103410643	169.09879482831903
chr22	42197305	42197805	2686	500	+	20.495110635169095	100.54522935737889
chr22	42197885	42198385	2687	500	+	38.42833244094206	13.710713094188028
chr22	42204385	42204885	2688	500	+	187.01788454591804	22.85118849031338
chr22	42217865	42218365	2689	500	+	30.742665952753647	36.56190158450141
chr22	42218625	42219205	2690	580	+	71.73288722309184	68.55356547094014
chr22	42221285	42221825	2691	540	+	79.41855371128025	123.39641784769225
chr22	42228665	42229332	2692	667	+	1201.5258609867883	315.34640116632465
chr22	42230365	42230985	2693	620	+	61.485331905507294	132.53689324381762
chr22	42234065	42234585	2694	520	+	46.113998929130474	54.84285237675211
chr22	42239405	42239905	2695	500	+	35.86644361154592	73.12380316900283
chr22	42240465	42240965	2696	500	+	28.180777123357508	41.13213928256408
chr22	42241865	42242385	2697	520	+	384.2833244094206	150.8178440360683
chr22	42244325	42244865	2698	540	+	61.485331905507294	27.421426188376056
chr22	42253465	42254005	2699	540	+	176.77032922833345	27.421426188376056
chr22	42257985	42258525	2700	540	+	48.675887758526606	31.991663886438737
chr22	42296305	42296805	2701	500	+	25.618888293961373	22.85118849031338
chr22	42310421	42310921	2702	500	+	10.247555317584547	4.570237698062677
chr22	42311725	42312245	2703	520	+	40.99022127033819	13.710713094188028
chr22	42314085	42314585	2704	500	+	33.304554782149786	9.140475396125353
chr22	42315645	42316145	2705	500	+	25.618888293961373	27.421426188376056
chr22	42321925	42322445	2706	520	+	51.237776587922745	4.570237698062677
chr22	42322571	42323071	2707	500	+	17.93322180577296	9.140475396125353
chr22	42323825	42324325	2708	500	+	66.60910956429957	4.570237698062677
chr22	42326325	42326825	2709	500	+	48.675887758526606	9.140475396125353
chr22	42335845	42336385	2710	540	+	40.99022127033819	36.56190158450141
chr22	42337185	42337725	2711	540	+	61.485331905507294	54.84285237675211
chr22	42342605	42343485	2712	880	+	527.7490988556043	425.0321059198289
chr22	42343725	42344245	2713	520	+	61.485331905507294	41.13213928256408
chr22	42346805	42347305	2714	500	+	43.552110099734335	22.85118849031338
chr22	42347940	42348440	2715	500	+	2.561888829396137	0.0
chr22	42353565	42354065	2716	500	+	87.10422019946867	22.85118849031338
chr22	42355725	42356225	2717	500	+	51.237776587922745	59.41309007481479
chr22	42356325	42356845	2718	520	+	148.58955210497595	86.83451626319085
chr22	42362625	42363125	2719	500	+	71.73288722309184	9.140475396125353
chr22	42372680	42373180	2720	500	+	0.0	4.570237698062677
chr22	42394478	42394978	2721	500	+	15.371332976376824	4.570237698062677
chr22	42397005	42397505	2722	500	+	30.742665952753647	4.570237698062677
chr22	42418425	42418925	2723	500	+	38.42833244094206	27.421426188376056
chr22	42465765	42466345	2724	580	+	89.6661090288648	301.6356880721366
chr22	42466585	42467096	2725	511	+	932.5275339001939	137.10713094188029
chr22	42468465	42468965	2726	500	+	25.618888293961373	13.710713094188028
chr22	42470004	42470504	2727	500	+	2.561888829396137	0.0
chr22	42475365	42476265	2728	900	+	806.9949812597832	365.6190158450141
chr22	42485865	42486505	2729	640	+	92.22799785826095	703.8166055016522
chr22	42486645	42487209	2730	564	+	973.5177551705322	370.18925354307675
chr22	42511485	42511985	2731	500	+	64.04722073490342	0.0
chr22	42514125	42514625	2732	500	+	33.304554782149786	4.570237698062677
chr22	42516305	42517185	2733	880	+	140.90388561678753	105.11546705544154
chr22	42526633	42527133	2734	500	+	2.561888829396137	0.0
chr22	42540326	42540826	2735	500	+	0.0	0.0
chr22	42564885	42565425	2736	540	+	87.10422019946867	13.710713094188028
chr22	42576225	42576745	2737	520	+	304.8647706981403	123.39641784769225
chr22	42578205	42578705	2738	500	+	12.809444146980686	31.991663886438737
chr22	42580765	42581285	2739	520	+	61.485331905507294	41.13213928256408
chr22	42584705	42585285	2740	580	+	46.113998929130474	41.13213928256408
chr22	42607225	42607745	2741	520	+	35.86644361154592	18.280950792250707
chr22	42627865	42628405	2742	540	+	43.552110099734335	4.570237698062677
chr22	42658885	42659385	2743	500	+	71.73288722309184	4.570237698062677
chr22	42664685	42666008	2744	1323	+	110.16121966403391	159.95831943219366
chr22	42666365	42666865	2745	500	+	15.371332976376824	18.280950792250707
chr22	42679683	42680183	2746	500	+	7.685666488188412	4.570237698062677
chr22	42695745	42696305	2747	560	+	40.99022127033819	36.56190158450141
chr22	42696665	42697205	2748	540	+	48.675887758526606	13.710713094188028
chr22	42709865	42710365	2749	500	+	48.675887758526606	4.570237698062677
chr22	42712925	42713425	2750	500	+	35.86644361154592	4.570237698062677
chr22	42764964	42765705	2751	741	+	253.6269941102176	36.56190158450141
chr22	42771865	42772385	2752	520	+	28.180777123357508	4.570237698062677
chr22	42772725	42773225	2753	500	+	28.180777123357508	36.56190158450141
chr22	42795565	42796065	2754	500	+	197.26543986350256	13.710713094188028
chr22	42808625	42809125	2755	500	+	79.41855371128025	150.8178440360683
chr22	42810605	42811305	2756	700	+	74.29477605248798	41.13213928256408
chr22	42814725	42815225	2757	500	+	28.180777123357508	4.570237698062677
chr22	42820305	42820825	2758	520	+	58.923443076111155	4.570237698062677
chr22	42821965	42822465	2759	500	+	66.60910956429957	0.0
chr22	42828151	42828651	2760	500	+	0.0	9.140475396125353
chr22	42833385	42833925	2761	540	+	61.485331905507294	31.991663886438737
chr22	42839965	42841045	2762	1080	+	507.2539882204352	361.0487781469514
chr22	42855725	42856225	2763	500	+	33.304554782149786	4.570237698062677
chr22	42858005	42858505	2764	500	+	309.9885483569326	9.140475396125353
chr22	42864845	42865345	2765	500	+	25.618888293961373	13.710713094188028
chr22	42869445	42869965	2766	520	+	53.79966541731888	9.140475396125353
chr22	42891645	42892185	2767	540	+	46.113998929130474	13.710713094188028
chr22	42894565	42895185	2768	620	+	220.32243932806782	27.421426188376056
chr22	42895225	42895725	2769	500	+	51.237776587922745	50.27261467868944
chr22	42895925	42896834	2770	909	+	276.68399357478285	36.56190158450141
chr22	42908245	42908745	2771	500	+	28.180777123357508	4.570237698062677
chr22	42915579	42916145	2772	566	+	102.47555317584549	82.26427856512817
chr22	42927385	42927885	2773	500	+	99.91366434644934	13.710713094188028
chr22	42929285	42929785	2774	500	+	79.41855371128025	45.70237698062676
chr22	42935165	42935665	2775	500	+	48.675887758526606	27.421426188376056
chr22	42937865	42938365	2776	500	+	12.809444146980686	0.0
chr22	42940625	42941145	2777	520	+	187.01788454591804	4.570237698062677
chr22	42943485	42943985	2778	500	+	33.304554782149786	4.570237698062677
chr22	42947205	42947725	2779	520	+	35.86644361154592	9.140475396125353
chr22	42947985	42948485	2780	500	+	40.99022127033819	4.570237698062677
chr22	42948825	42949325	2781	500	+	33.304554782149786	36.56190158450141
chr22	42949617	42950125	2782	508	+	374.0357690918361	146.24760633800565
chr22	42958085	42958705	2783	620	+	87.10422019946867	77.6940408670655
chr22	42977767	42978365	2784	598	+	58.923443076111155	50.27261467868944
chr22	43008785	43009365	2785	580	+	51.237776587922745	45.70237698062676
chr22	43010405	43011725	2786	1320	+	1532.00951997889	1183.6915637982331
chr22	43013525	43014025	2787	500	+	38.42833244094206	31.991663886438737
chr22	43016525	43017045	2788	520	+	174.20844039893734	105.11546705544154
chr22	43017525	43018025	2789	500	+	76.85666488188411	18.280950792250707
chr22	43036357	43036857	2790	500	+	2.561888829396137	0.0
chr22	43038705	43039225	2791	520	+	148.58955210497595	105.11546705544154
chr22	43042745	43043345	2792	600	+	133.21821912859915	77.6940408670655
chr22	43044245	43044785	2793	540	+	43.552110099734335	178.23927022444437
chr22	43045265	43045765	2794	500	+	51.237776587922745	18.280950792250707
chr22	43052425	43052945	2795	520	+	61.485331905507294	0.0
chr22	43057885	43058585	2796	700	+	97.35177551705321	22.85118849031338
chr22	43076585	43077085	2797	500	+	46.113998929130474	9.140475396125353
chr22	43084285	43084825	2798	540	+	97.35177551705321	13.710713094188028
chr22	43110805	43111305	2799	500	+	33.304554782149786	9.140475396125353
chr22	43113305	43113845	2800	540	+	102.47555317584549	13.710713094188028
chr22	43116666	43117166	2801	500	+	5.123777658792274	4.570237698062677
chr22	43118865	43119425	2802	560	+	97.35177551705321	13.710713094188028
chr22	43136365	43136865	2803	500	+	28.180777123357508	0.0
chr22	43150645	43151145	2804	500	+	525.1872100262082	22.85118849031338
chr22	43165905	43166425	2805	520	+	74.29477605248798	4.570237698062677
chr22	43176045	43176545	2806	500	+	189.57977337531415	13.710713094188028
chr22	43199565	43200065	2807	500	+	25.618888293961373	13.710713094188028
chr22	43216045	43216605	2808	560	+	56.361554246715016	4.570237698062677
chr22	43252105	43252605	2809	500	+	23.056999464565237	100.54522935737889
chr22	43253085	43253658	2810	573	+	307.42665952753646	123.39641784769225
chr22	43259125	43259645	2811	520	+	25.618888293961373	4.570237698062677
chr22	43263685	43264205	2812	520	+	143.46577444618367	4.570237698062677
chr22	43315105	43315665	2813	560	+	51.237776587922745	31.991663886438737
chr22	43329385	43329905	2814	520	+	81.98044254067638	31.991663886438737
chr22	43333365	43333905	2815	540	+	51.237776587922745	22.85118849031338
chr22	43336125	43336625	2816	500	+	25.618888293961373	31.991663886438737
chr22	43341425	43342165	2817	740	+	99.91366434644934	68.55356547094014
chr22	43343085	43343605	2818	520	+	30.742665952753647	41.13213928256408
chr22	43344225	43344725	2819	500	+	35.86644361154592	9.140475396125353
chr22	43345045	43345545	2820	500	+	28.180777123357508	13.710713094188028
chr22	43354965	43355465	2821	500	+	71.73288722309184	169.09879482831903
chr22	43355645	43356605	2822	960	+	386.8452132388167	548.4285237675211
chr22	43358145	43358705	2823	560	+	81.98044254067638	45.70237698062676
chr22	43363885	43364425	2824	540	+	56.361554246715016	36.56190158450141
chr22	43366585	43367105	2825	520	+	48.675887758526606	27.421426188376056
chr22	43373445	43373945	2826	500	+	23.056999464565237	22.85118849031338
chr22	43378665	43379225	2827	560	+	38.42833244094206	4.570237698062677
chr22	43381445	43381985	2828	540	+	51.237776587922745	9.140475396125353
chr22	43386865	43387365	2829	500	+	46.113998929130474	9.140475396125353
chr22	43396405	43396905	2830	500	+	112.72310849343003	68.55356547094014
chr22	43398265	43398805	2831	540	+	69.17099839369571	50.27261467868944
chr22	43399665	43400185	2832	520	+	66.60910956429957	31.991663886438737
chr22	43403585	43404085	2833	500	+	532.8728765143966	82.26427856512817
chr22	43409945	43410445	2834	500	+	23.056999464565237	31.991663886438737
chr22	43410934	43411545	2835	611	+	420.1497680209665	77.6940408670655
chr22	43429785	43430325	2836	540	+	92.22799785826095	0.0
chr22	43434265	43434840	2837	575	+	81.98044254067638	9.140475396125353
chr22	43456145	43456665	2838	520	+	35.86644361154592	0.0
chr22	43463385	43463885	2839	500	+	51.237776587922745	4.570237698062677
chr22	43485184	43485705	2840	521	+	133.21821912859915	63.98332777287747
chr22	43486085	43486605	2841	520	+	279.24588240417893	22.85118849031338
chr22	43496125	43496625	2842	500	+	76.85666488188411	18.280950792250707
chr22	43497145	43497705	2843	560	+	84.54233137007253	77.6940408670655
chr22	43499905	43500425	2844	520	+	161.39899625195665	159.95831943219366
chr22	43506503	43507003	2845	500	+	7.685666488188412	13.710713094188028
chr22	43520765	43521325	2846	560	+	43.552110099734335	13.710713094188028
chr22	43539153	43539705	2847	552	+	151.15144093437212	196.52022101669507
chr22	43547269	43547769	2848	500	+	17.93322180577296	63.98332777287747
chr22	43559765	43560265	2849	500	+	248.50321645142532	45.70237698062676
chr22	43561485	43562065	2850	580	+	69.17099839369571	36.56190158450141
chr22	43563085	43563605	2851	520	+	89.6661090288648	27.421426188376056
chr22	43579425	43579965	2852	540	+	481.6350999264738	685.5356547094015
chr22	43582887	43583387	2853	500	+	5.123777658792274	82.26427856512817
chr22	43583425	43583945	2854	520	+	366.3501026036476	127.96665554575495
chr22	43585025	43585525	2855	500	+	35.86644361154592	27.421426188376056
chr22	43592385	43593365	2856	980	+	58.923443076111155	9.140475396125353
chr22	43608429	43609425	2857	996	+	38.42833244094206	4.570237698062677
chr22	43614865	43615405	2858	540	+	35.86644361154592	31.991663886438737
chr22	43615925	43616465	2859	540	+	38.42833244094206	4.570237698062677
chr22	43618125	43618665	2860	540	+	89.6661090288648	13.710713094188028
chr22	43624285	43624785	2861	500	+	58.923443076111155	4.570237698062677
chr22	43627145	43627665	2862	520	+	79.41855371128025	9.140475396125353
chr22	43659105	43659645	2863	540	+	46.113998929130474	4.570237698062677
chr22	43659745	43660525	2864	780	+	402.21654621519355	50.27261467868944
chr22	43669865	43670365	2865	500	+	38.42833244094206	4.570237698062677
chr22	43671445	43672197	2866	752	+	222.88432815746395	27.421426188376056
chr22	43674145	43674645	2867	500	+	33.304554782149786	4.570237698062677
chr22	43689145	43690145	2868	1000	+	199.82732869289867	269.6440241856979
chr22	43706185	43706685	2869	500	+	12.809444146980686	13.710713094188028
chr22	43722445	43722945	2870	500	+	69.17099839369571	13.710713094188028
chr22	43739144	43739644	2871	500	+	10.247555317584547	0.0
chr22	43741745	43742625	2872	880	+	53.79966541731888	36.56190158450141
chr22	43755825	43756385	2873	560	+	35.86644361154592	13.710713094188028
chr22	43781625	43782125	2874	500	+	66.60910956429957	18.280950792250707
chr22	43807769	43808269	2875	500	+	0.0	0.0
chr22	43911883	43912383	2876	500	+	7.685666488188412	9.140475396125353
chr22	44207967	44208467	2877	500	+	2.561888829396137	18.280950792250707
chr22	44258128	44258628	2878	500	+	5.123777658792274	0.0
chr22	44278845	44279345	2879	500	+	107.59933083463775	4.570237698062677
chr22	44280805	44281305	2880	500	+	28.180777123357508	0.0
chr22	44287643	44288143	2881	500	+	0.0	0.0
chr22	44298885	44299405	2882	520	+	56.361554246715016	9.140475396125353
chr22	44319368	44319905	2883	537	+	125.53255264041073	22.85118849031338
chr22	44341685	44342185	2884	500	+	53.79966541731888	22.85118849031338
chr22	44350185	44350685	2885	500	+	40.99022127033819	31.991663886438737
chr22	44351010	44351525	2886	515	+	217.76055049867165	251.3630733934472
chr22	44351705	44352205	2887	500	+	40.99022127033819	210.23093411088308
chr22	44365325	44365845	2888	520	+	376.59765792123216	260.5035487895725
chr22	44381325	44381865	2889	540	+	368.9119914330438	223.94164720507112
chr22	44394840	44395340	2890	500	+	2.561888829396137	0.0
chr22	44400145	44400705	2891	560	+	61.485331905507294	22.85118849031338
chr22	44401325	44401845	2892	520	+	97.35177551705321	13.710713094188028
chr22	44411565	44412065	2893	500	+	33.304554782149786	18.280950792250707
chr22	44416725	44417805	2894	1080	+	56.361554246715016	123.39641784769225
chr22	44421365	44421925	2895	560	+	156.27521859316437	150.8178440360683
chr22	44422625	44423125	2896	500	+	130.65633029920298	223.94164720507112
chr22	44426705	44427245	2897	540	+	81.98044254067638	109.68570475350423
chr22	44438625	44439125	2898	500	+	20.495110635169095	27.421426188376056
chr22	44439665	44440165	2899	500	+	28.180777123357508	22.85118849031338
chr22	44442385	44442885	2900	500	+	589.2344307611115	31.991663886438737
chr22	44464545	44465045	2901	500	+	25.618888293961373	13.710713094188028
chr22	44525385	44525905	2902	520	+	35.86644361154592	4.570237698062677
chr22	44568145	44568665	2903	520	+	58.923443076111155	9.140475396125353
chr22	44576519	44577019	2904	500	+	12.809444146980686	18.280950792250707
chr22	44588125	44588645	2905	520	+	153.71332976376823	4.570237698062677
chr22	44708481	44708981	2906	500	+	0.0	4.570237698062677
chr22	44838956	44839456	2907	500	+	5.123777658792274	4.570237698062677
chr22	44845225	44845745	2908	520	+	53.79966541731888	41.13213928256408
chr22	44893755	44894585	2909	830	+	146.0276632755798	22.85118849031338
chr22	44964969	44965469	2910	500	+	5.123777658792274	13.710713094188028
chr22	45016165	45016665	2911	500	+	12.809444146980686	0.0
chr22	45021049	45021549	2912	500	+	2.561888829396137	4.570237698062677
chr22	45022005	45022505	2913	500	+	43.552110099734335	0.0
chr22	45065505	45066005	2914	500	+	25.618888293961373	9.140475396125353
chr22	45067605	45068105	2915	500	+	30.742665952753647	9.140475396125353
chr22	45071065	45071565	2916	500	+	35.86644361154592	27.421426188376056
chr22	45072437	45073025	2917	588	+	417.5878791915704	356.47854044888874
chr22	45077605	45078105	2918	500	+	33.304554782149786	22.85118849031338
chr22	45078325	45078845	2919	520	+	51.237776587922745	77.6940408670655
chr22	45080505	45081025	2920	520	+	315.1123260157249	114.25594245156691
chr22	45081225	45081725	2921	500	+	184.4559957165219	73.12380316900283
chr22	45084985	45085485	2922	500	+	153.71332976376823	18.280950792250707
chr22	45089225	45089785	2923	560	+	30.742665952753647	54.84285237675211
chr22	45093245	45093745	2924	500	+	43.552110099734335	9.140475396125353
chr22	45097205	45097725	2925	520	+	53.79966541731888	54.84285237675211
chr22	45097827	45098327	2926	500	+	15.371332976376824	13.710713094188028
chr22	45117045	45117545	2927	500	+	12.809444146980686	0.0
chr22	45119605	45120125	2928	520	+	74.29477605248798	22.85118849031338
chr22	45134185	45134685	2929	500	+	23.056999464565237	0.0
chr22	45135585	45136125	2930	540	+	33.304554782149786	4.570237698062677
chr22	45143545	45144065	2931	520	+	38.42833244094206	4.570237698062677
chr22	45148187	45148687	2932	500	+	5.123777658792274	0.0
chr22	45196025	45196525	2933	500	+	33.304554782149786	0.0
chr22	45216405	45216905	2934	500	+	20.495110635169095	4.570237698062677
chr22	45223945	45224445	2935	500	+	35.86644361154592	0.0
chr22	45265845	45266345	2936	500	+	30.742665952753647	22.85118849031338
chr22	45371385	45371885	2937	500	+	61.485331905507294	4.570237698062677
chr22	45404624	45405124	2938	500	+	15.371332976376824	0.0
chr22	45468105	45468605	2939	500	+	20.495110635169095	4.570237698062677
chr22	45492105	45492605	2940	500	+	28.180777123357508	9.140475396125353
chr22	45497665	45498165	2941	500	+	46.113998929130474	9.140475396125353
chr22	45535865	45536365	2942	500	+	23.056999464565237	0.0
chr22	45548215	45548715	2943	500	+	2.561888829396137	0.0
chr22	45555465	45555985	2944	520	+	110.16121966403391	59.41309007481479
chr22	45559475	45559985	2945	510	+	333.04554782149785	82.26427856512817
chr22	45565965	45566525	2946	560	+	217.76055049867165	36.56190158450141
chr22	45588385	45589205	2947	820	+	189.57977337531415	41.13213928256408
chr22	45608085	45608585	2948	500	+	7.685666488188412	0.0
chr22	45619225	45619725	2949	500	+	58.923443076111155	9.140475396125353
chr22	45635125	45635625	2950	500	+	20.495110635169095	4.570237698062677
chr22	45636400	45636900	2951	500	+	12.809444146980686	0.0
chr22	45645165	45646185	2952	1020	+	79.41855371128025	31.991663886438737
chr22	45650865	45651365	2953	500	+	17.93322180577296	4.570237698062677
chr22	45659565	45660085	2954	520	+	58.923443076111155	13.710713094188028
chr22	45664785	45665285	2955	500	+	40.99022127033819	9.140475396125353
chr22	45675645	45676205	2956	560	+	53.79966541731888	0.0
chr22	45676365	45676865	2957	500	+	35.86644361154592	4.570237698062677
chr22	45680617	45681117	2958	500	+	0.0	4.570237698062677
chr22	45686485	45686985	2959	500	+	35.86644361154592	18.280950792250707
chr22	45697845	45698345	2960	500	+	46.113998929130474	13.710713094188028
chr22	45705305	45706034	2961	729	+	353.5406584566669	187.37974562056974
chr22	45708565	45709065	2962	500	+	71.73288722309184	68.55356547094014
chr22	45709865	45710365	2963	500	+	202.38921752229484	420.46186822176617
chr22	45710605	45711125	2964	520	+	120.40877498161845	329.05711426051266
chr22	45711605	45712125	2965	520	+	66.60910956429957	9.140475396125353
chr22	45712745	45713245	2966	500	+	17.93322180577296	27.421426188376056
chr22	45713965	45714485	2967	520	+	69.17099839369571	13.710713094188028
chr22	45737405	45737905	2968	500	+	17.93322180577296	4.570237698062677
chr22	45748505	45749045	2969	540	+	30.742665952753647	9.140475396125353
chr22	45809250	45809821	2970	571	+	7.685666488188412	0.0
chr22	45831465	45832005	2971	540	+	79.41855371128025	0.0
chr22	45898468	45898968	2972	500	+	5.123777658792274	0.0
chr22	45944925	45945445	2973	520	+	69.17099839369571	9.140475396125353
chr22	45949565	45950085	2974	520	+	35.86644361154592	31.991663886438737
chr22	45973765	45974345	2975	580	+	43.552110099734335	4.570237698062677
chr22	45998565	45999065	2976	500	+	184.4559957165219	0.0
chr22	46001277	46001777	2977	500	+	0.0	0.0
chr22	46014465	46014985	2978	520	+	74.29477605248798	68.55356547094014
chr22	46022165	46022665	2979	500	+	25.618888293961373	13.710713094188028
chr22	46025265	46025765	2980	500	+	17.93322180577296	0.0
chr22	46032565	46033065	2981	500	+	40.99022127033819	4.570237698062677
chr22	46034825	46035345	2982	520	+	33.304554782149786	68.55356547094014
chr22	46038745	46039325	2983	580	+	89.6661090288648	4.570237698062677
chr22	46041165	46041665	2984	500	+	15.371332976376824	13.710713094188028
chr22	46067405	46067927	2985	522	+	76.85666488188411	77.6940408670655
chr22	46069605	46070185	2986	580	+	51.237776587922745	9.140475396125353
chr22	46080005	46080505	2987	500	+	38.42833244094206	4.570237698062677
chr22	46085105	46085625	2988	520	+	46.113998929130474	13.710713094188028
chr22	46156525	46157045	2989	520	+	74.29477605248798	27.421426188376056
chr22	46259685	46260185	2990	500	+	51.237776587922745	4.570237698062677
chr22	46372758	46373258	2991	500	+	2.561888829396137	4.570237698062677
chr22	46374905	46375425	2992	520	+	46.113998929130474	9.140475396125353
chr22	46402145	46402745	2993	600	+	58.923443076111155	9.140475396125353
chr22	46409205	46410225	2994	1020	+	353.5406584566669	502.7261467868944
chr22	46410945	46411445	2995	500	+	58.923443076111155	13.710713094188028
chr22	46431545	46432065	2996	520	+	486.7588775852661	9.140475396125353
chr22	46432565	46433065	2997	500	+	17.93322180577296	105.11546705544154
chr22	46440498	46440998	2998	500	+	2.561888829396137	0.0
chr22	46449475	46450274	2999	799	+	5.123777658792274	0.0
chr22	46480745	46481285	3000	540	+	40.99022127033819	196.52022101669507
chr22	46481585	46482126	3001	541	+	110.16121966403391	233.0821226011965
chr22	46505025	46505525	3002	500	+	25.618888293961373	0.0
chr22	46512125	46512765	3003	640	+	38.42833244094206	4.570237698062677
chr22	46515885	46516385	3004	500	+	15.371332976376824	27.421426188376056
chr22	46546045	46546748	3005	703	+	25.618888293961373	4.570237698062677
chr22	46566885	46567405	3006	520	+	71.73288722309184	18.280950792250707
chr22	46576185	46576725	3007	540	+	220.32243932806782	50.27261467868944
chr22	46579665	46580165	3008	500	+	30.742665952753647	18.280950792250707
chr22	46587105	46587605	3009	500	+	30.742665952753647	0.0
chr22	46589805	46590305	3010	500	+	350.97876962727076	18.280950792250707
chr22	46630865	46631445	3011	580	+	302.30288186874424	141.67736863994298
chr22	46635525	46636025	3012	500	+	97.35177551705321	18.280950792250707
chr22	46637165	46637725	3013	560	+	58.923443076111155	59.41309007481479
chr22	46645943	46646505	3014	562	+	243.37943879263304	182.80950792250704
chr22	46647025	46647525	3015	500	+	40.99022127033819	191.9499833186324
chr22	46650045	46650605	3016	560	+	87.10422019946867	13.710713094188028
chr22	46652205	46652725	3017	520	+	333.04554782149785	73.12380316900283
chr22	46658969	46659469	3018	500	+	0.0	0.0
chr22	46663505	46664110	3019	605	+	217.76055049867165	100.54522935737889
chr22	46692307	46692905	3020	598	+	453.45432280311627	283.35473727988597
chr22	46703005	46703585	3021	580	+	48.675887758526606	100.54522935737889
chr22	46710025	46710585	3022	560	+	46.113998929130474	9.140475396125353
chr22	46730445	46730965	3023	520	+	43.552110099734335	22.85118849031338
chr22	46731047	46731845	3024	798	+	151.15144093437212	201.09045871475777
chr22	46751205	46751705	3025	500	+	12.809444146980686	9.140475396125353
chr22	46786385	46787045	3026	660	+	79.41855371128025	18.280950792250707
chr22	46851945	46852445	3027	500	+	302.30288186874424	22.85118849031338
chr22	46858505	46859005	3028	500	+	64.04722073490342	4.570237698062677
chr22	46887985	46888485	3029	500	+	30.742665952753647	9.140475396125353
chr22	46891125	46891625	3030	500	+	64.04722073490342	18.280950792250707
chr22	46924005	46924545	3031	540	+	66.60910956429957	18.280950792250707
chr22	46932817	46933317	3032	500	+	0.0	0.0
chr22	46943765	46944265	3033	500	+	38.42833244094206	9.140475396125353
chr22	46957305	46957825	3034	520	+	33.304554782149786	31.991663886438737
chr22	46959165	46960085	3035	920	+	122.97066381101459	59.41309007481479
chr22	46971005	46971645	3036	640	+	48.675887758526606	27.421426188376056
chr22	46971705	46972205	3037	500	+	20.495110635169095	22.85118849031338
chr22	46974925	46975425	3038	500	+	64.04722073490342	77.6940408670655
chr22	46988145	46988685	3039	540	+	76.85666488188411	59.41309007481479
chr22	46994825	46995405	3040	580	+	46.113998929130474	31.991663886438737
chr22	46999685	47000725	3041	1040	+	873.6040908240827	1320.7986947401134
chr22	47015505	47016548	3042	1043	+	35.86644361154592	27.421426188376056
chr22	47029925	47030445	3043	520	+	33.304554782149786	68.55356547094014
chr22	47030765	47031685	3044	920	+	125.53255264041073	18.280950792250707
chr22	47042645	47043205	3045	560	+	48.675887758526606	4.570237698062677
chr22	47045265	47045805	3046	540	+	261.31266059840596	205.66069641282044
chr22	47047865	47048405	3047	540	+	122.97066381101459	114.25594245156691
chr22	47106685	47107225	3048	540	+	64.04722073490342	22.85118849031338
chr22	47130885	47131425	3049	540	+	28.180777123357508	27.421426188376056
chr22	47133902	47134465	3050	563	+	25.618888293961373	4.570237698062677
chr22	47149865	47150765	3051	900	+	381.72143558002443	1078.5760967427916
chr22	47154645	47155165	3052	520	+	61.485331905507294	9.140475396125353
chr22	47158205	47158763	3053	558	+	333.04554782149785	365.6190158450141
chr22	47169685	47170225	3054	540	+	187.01788454591804	54.84285237675211
chr22	47194385	47194885	3055	500	+	79.41855371128025	22.85118849031338
chr22	47198925	47199705	3056	780	+	79.41855371128025	9.140475396125353
chr22	47212045	47212785	3057	740	+	212.63677283987937	91.40475396125352
chr22	47250045	47250545	3058	500	+	20.495110635169095	50.27261467868944
chr22	47261425	47261925	3059	500	+	53.79966541731888	0.0
chr22	47274385	47274905	3060	520	+	38.42833244094206	9.140475396125353
chr22	47291625	47292125	3061	500	+	333.04554782149785	86.83451626319085
chr22	47293045	47293545	3062	500	+	15.371332976376824	9.140475396125353
chr22	47295365	47295865	3063	500	+	33.304554782149786	27.421426188376056
chr22	47311688	47312188	3064	500	+	7.685666488188412	4.570237698062677
chr22	47330705	47331205	3065	500	+	397.09276855640127	507.29638448495706
chr22	47331525	47332085	3066	560	+	166.52277391074892	397.6106797314528
chr22	47484405	47484905	3067	500	+	46.113998929130474	27.421426188376056
chr22	47485545	47486085	3068	540	+	102.47555317584549	63.98332777287747
chr22	47486725	47487245	3069	520	+	399.65465738579735	77.6940408670655
chr22	47503265	47503865	3070	600	+	40.99022127033819	36.56190158450141
chr22	47525505	47526045	3071	540	+	81.98044254067638	68.55356547094014
chr22	47551465	47552005	3072	540	+	28.180777123357508	0.0
chr22	47702985	47703545	3073	560	+	56.361554246715016	22.85118849031338
chr22	47724485	47725005	3074	520	+	51.237776587922745	4.570237698062677
chr22	47733005	47733505	3075	500	+	43.552110099734335	22.85118849031338
chr22	47741070	47741570	3076	500	+	0.0	13.710713094188028
chr22	47847865	47848385	3077	520	+	38.42833244094206	4.570237698062677
chr22	47882610	47883110	3078	500	+	7.685666488188412	18.280950792250707
chr22	48022625	48023125	3079	500	+	28.180777123357508	9.140475396125353
chr22	48027068	48027685	3080	617	+	210.07488401048326	397.6106797314528
chr22	48041045	48041545	3081	500	+	76.85666488188411	100.54522935737889
chr22	48059505	48060085	3082	580	+	69.17099839369571	100.54522935737889
chr22	48073805	48074325	3083	520	+	294.61721538055576	91.40475396125352
chr22	48093525	48094045	3084	520	+	79.41855371128025	13.710713094188028
chr22	48109685	48110225	3085	540	+	51.237776587922745	73.12380316900283
chr22	48112525	48113045	3086	520	+	97.35177551705321	31.991663886438737
chr22	48170845	48171385	3087	540	+	46.113998929130474	9.140475396125353
chr22	48175185	48175685	3088	500	+	284.3696600629712	27.421426188376056
chr22	48233385	48233885	3089	500	+	28.180777123357508	9.140475396125353
chr22	48246645	48247145	3090	500	+	20.495110635169095	4.570237698062677
chr22	48485785	48486285	3091	500	+	20.495110635169095	4.570237698062677
chr22	48942949	48943449	3092	500	+	2.561888829396137	0.0
chr22	48971867	48972367	3093	500	+	0.0	0.0
chr22	49262331	49262831	3094	500	+	7.685666488188412	9.140475396125353
chr22	49599485	49600005	3095	520	+	28.180777123357508	9.140475396125353
chr22	49677805	49678325	3096	520	+	33.304554782149786	13.710713094188028
chr22	49700985	49701485	3097	500	+	38.42833244094206	9.140475396125353
chr22	49764965	49765505	3098	540	+	56.361554246715016	0.0
chr22	49768505	49769025	3099	520	+	76.85666488188411	0.0
chr22	49816185	49816685	3100	500	+	23.056999464565237	4.570237698062677
chr22	49839205	49839765	3101	560	+	56.361554246715016	13.710713094188028
chr22	49844125	49844645	3102	520	+	61.485331905507294	18.280950792250707
chr22	49856485	49857005	3103	520	+	46.113998929130474	0.0
chr22	49874825	49875325	3104	500	+	110.16121966403391	4.570237698062677
chr22	49883885	49884385	3105	500	+	33.304554782149786	13.710713094188028
chr22	49895665	49896205	3106	540	+	46.113998929130474	9.140475396125353
chr22	49897145	49897645	3107	500	+	38.42833244094206	9.140475396125353
chr22	49919405	49919905	3108	500	+	33.304554782149786	22.85118849031338
chr22	50048905	50049405	3109	500	+	15.371332976376824	13.710713094188028
chr22	50050925	50051745	3110	820	+	476.5113222676815	223.94164720507112
chr22	50098105	50098605	3111	500	+	207.51299518108712	13.710713094188028
chr22	50117705	50118205	3112	500	+	33.304554782149786	4.570237698062677
chr22	50118405	50118925	3113	520	+	71.73288722309184	0.0
chr22	50145505	50146065	3114	560	+	43.552110099734335	22.85118849031338
chr22	50160885	50161385	3115	500	+	53.79966541731888	9.140475396125353
chr22	50179565	50180085	3116	520	+	107.59933083463775	31.991663886438737
chr22	50199765	50200425	3117	660	+	69.17099839369571	45.70237698062676
chr22	50201725	50202225	3118	500	+	617.415207884469	671.8249416152134
chr22	50203845	50204345	3119	500	+	40.99022127033819	9.140475396125353
chr22	50219298	50220065	3120	767	+	40.99022127033819	109.68570475350423
chr22	50232385	50232965	3121	580	+	89.6661090288648	4.570237698062677
chr22	50247025	50247746	3122	721	+	256.1888829396137	132.53689324381762
chr22	50265045	50265565	3123	520	+	30.742665952753647	9.140475396125353
chr22	50265925	50266425	3124	500	+	107.59933083463775	73.12380316900283
chr22	50310905	50311405	3125	500	+	20.495110635169095	36.56190158450141
chr22	50311856	50312527	3126	671	+	335.607436650894	109.68570475350423
chr22	50324465	50324965	3127	500	+	46.113998929130474	18.280950792250707
chr22	50326905	50327405	3128	500	+	23.056999464565237	4.570237698062677
chr22	50327745	50328265	3129	520	+	102.47555317584549	36.56190158450141
chr22	50328765	50329285	3130	520	+	30.742665952753647	9.140475396125353
chr22	50329625	50330125	3131	500	+	404.7784350445897	22.85118849031338
chr22	50338945	50339465	3132	520	+	105.03744200524163	18.280950792250707
chr22	50353745	50354392	3133	647	+	630.2246520314498	141.67736863994298
chr22	50355905	50356425	3134	520	+	204.95110635169098	132.53689324381762
chr22	50360525	50361045	3135	520	+	105.03744200524163	41.13213928256408
chr22	50364385	50364885	3136	500	+	294.61721538055576	159.95831943219366
chr22	50414685	50415245	3137	560	+	58.923443076111155	9.140475396125353
chr22	50417945	50418505	3138	560	+	66.60910956429957	9.140475396125353
chr22	50430225	50430725	3139	500	+	43.552110099734335	4.570237698062677
chr22	50437385	50437885	3140	500	+	74.29477605248798	100.54522935737889
chr22	50440285	50440805	3141	520	+	53.79966541731888	27.421426188376056
chr22	50450805	50451305	3142	500	+	7.685666488188412	4.570237698062677
chr22	50468625	50469145	3143	520	+	43.552110099734335	13.710713094188028
chr22	50499985	50500485	3144	500	+	15.371332976376824	0.0
chr22	50517105	50517605	3145	500	+	35.86644361154592	4.570237698062677
chr22	50523531	50524605	3146	1074	+	207.51299518108712	137.10713094188029
chr22	50528184	50528684	3147	500	+	5.123777658792274	0.0
chr22	50540525	50541025	3148	500	+	33.304554782149786	18.280950792250707
chr22	50541305	50541805	3149	500	+	30.742665952753647	18.280950792250707
chr22	50542365	50542925	3150	560	+	107.59933083463775	63.98332777287747
chr22	50544105	50544625	3151	520	+	99.91366434644934	41.13213928256408
chr22	50555485	50556005	3152	520	+	194.70355103410643	173.6690325263817
chr22	50557005	50557545	3153	540	+	689.148095107561	575.8499499558972
chr22	50557745	50558245	3154	500	+	40.99022127033819	699.2463678035895
chr22	50558505	50559005	3155	500	+	38.42833244094206	27.421426188376056
chr22	50578485	50579045	3156	560	+	135.78010795799528	45.70237698062676
chr22	50585085	50585585	3157	500	+	43.552110099734335	4.570237698062677
chr22	50587465	50587965	3158	500	+	110.16121966403391	4.570237698062677
chr22	50589085	50589585	3159	500	+	28.180777123357508	9.140475396125353
chr22	50606085	50606585	3160	500	+	33.304554782149786	4.570237698062677
chr22	50608345	50608885	3161	540	+	48.675887758526606	36.56190158450141
chr22	50608909	50609409	3162	500	+	5.123777658792274	18.280950792250707
chr22	50623965	50624590	3163	625	+	81.98044254067638	137.10713094188029
chr22	50628665	50629185	3164	520	+	143.46577444618367	150.8178440360683
chr22	50639085	50639657	3165	572	+	151.15144093437212	50.27261467868944
chr22	50642965	50643505	3166	540	+	30.742665952753647	4.570237698062677
chr22	50648245	50648745	3167	500	+	28.180777123357508	4.570237698062677
chr22	50657725	50658225	3168	500	+	46.113998929130474	4.570237698062677
chr22	50679465	50680425	3169	960	+	107.59933083463775	36.56190158450141
chr22	50682185	50682685	3170	500	+	25.618888293961373	237.65236029925916
chr22	50682765	50683765	3171	1000	+	245.94132762202918	530.1475729752705
chr22	50686085	50686585	3172	500	+	38.42833244094206	31.991663886438737
chr22	50688865	50689365	3173	500	+	33.304554782149786	100.54522935737889
chr22	50689525	50690084	3174	559	+	102.47555317584549	22.85118849031338
chr22	50691885	50692465	3175	580	+	28.180777123357508	9.140475396125353
chr22	50699325	50699845	3176	520	+	48.675887758526606	164.52855713025633
chr22	50699989	50700565	3177	576	+	35.86644361154592	27.421426188376056
chr22	50700885	50701385	3178	500	+	58.923443076111155	95.9749916593162
chr22	50706005	50706505	3179	500	+	15.371332976376824	4.570237698062677
chr22	50707825	50709565	3180	1740	+	125.53255264041073	68.55356547094014
chr22	50710005	50710505	3181	500	+	92.22799785826095	4.570237698062677
chr22	50742885	50743425	3182	540	+	48.675887758526606	22.85118849031338
chr22	50744265	50744765	3183	500	+	28.180777123357508	95.9749916593162
chr22	50745751	50746325	3184	574	+	99.91366434644934	9.140475396125353
chr22	50746945	50747465	3185	520	+	228.0081058162562	73.12380316900283
chr22	50752725	50753245	3186	520	+	138.34199678739142	105.11546705544154
chr22	50757445	50757985	3187	540	+	151.15144093437212	114.25594245156691
chr22	50765239	50765825	3188	586	+	53.79966541731888	169.09879482831903
chr22	50768725	50769225	3189	500	+	56.361554246715016	54.84285237675211
chr22	50769325	50769825	3190	500	+	153.71332976376823	292.4952126760113
chr22	50778805	50779385	3191	580	+	64.04722073490342	54.84285237675211
chr22	50779845	50780345	3192	500	+	12.809444146980686	13.710713094188028
chr22	50780625	50781145	3193	520	+	112.72310849343003	109.68570475350423
chr22	50781495	50781995	3194	500	+	28.180777123357508	123.39641784769225
chr22	50804885	50805385	3195	500	+	38.42833244094206	18.280950792250707
chr22	50888005	50888525	3196	520	+	35.86644361154592	22.85118849031338
chr22	50891565	50892085	3197	520	+	87.10422019946867	68.55356547094014
chr22	50908185	50908745	3198	560	+	74.29477605248798	4.570237698062677
chr22	50913250	50913805	3199	555	+	138.34199678739142	27.421426188376056
chr22	50919645	50920402	3200	757	+	35.86644361154592	22.85118849031338
chr22	50924962	50925462	3201	500	+	20.495110635169095	9.140475396125353
chr22	50936565	50937385	3202	820	+	671.214873301788	86.83451626319085
chr22	50938845	50939345	3203	500	+	33.304554782149786	27.421426188376056
chr22	50945885	50947385	3204	1500	+	497.00643290285063	813.5023102551563
chr22	50948185	50948685	3205	500	+	51.237776587922745	100.54522935737889
chr22	50962925	50963425	3206	500	+	35.86644361154592	118.82618014962958
chr22	50963783	50964745	3207	962	+	438.0829898267395	246.7928356953845
chr22	50965205	50965705	3208	500	+	138.34199678739142	219.37140950700845
chr22	50968264	50968764	3209	500	+	5.123777658792274	0.0
chr22	50970758	50971258	3210	500	+	10.247555317584547	0.0
chr22	50971745	50972265	3211	520	+	130.65633029920298	36.56190158450141
chr22	50972565	50973205	3212	640	+	202.38921752229484	31.991663886438737
chr22	50977565	50978445	3213	880	+	573.8630977847347	169.09879482831903
chr22	50979165	50979785	3214	620	+	46.113998929130474	9.140475396125353
chr22	50980005	50980505	3215	500	+	28.180777123357508	9.140475396125353
chr22	50986211	50986711	3216	500	+	5.123777658792274	0.0
chr22	51001125	51001631	3217	506	+	353.5406584566669	31.991663886438737
chr22	51007125	51007625	3218	500	+	28.180777123357508	27.421426188376056
chr22	51014465	51014965	3219	500	+	92.22799785826095	9.140475396125353
chr22	51016846	51017346	3220	500	+	5.123777658792274	9.140475396125353
chr22	51020805	51021705	3221	900	+	609.7295413962806	246.7928356953845
chr22	51038863	51039363	3222	500	+	5.123777658792274	0.0
chr22	51050725	51051225	3223	500	+	35.86644361154592	22.85118849031338
chr22	51052045	51052545	3224	500	+	102.47555317584549	13.710713094188028
chr22	51058785	51059545	3225	760	+	105.03744200524163	9.140475396125353
chr22	51066351	51066985	3226	634	+	53.79966541731888	68.55356547094014
chr22	51112819	51113319	3227	500	+	2.561888829396137	0.0
chr22	51129865	51130425	3228	560	+	51.237776587922745	13.710713094188028
chr22	51170465	51171025	3229	560	+	30.742665952753647	22.85118849031338
chr22	51176347	51176901	3230	554	+	7.685666488188412	9.140475396125353
chr22	51195325	51196145	3231	820	+	48.675887758526606	4.570237698062677
chr22	51198405	51198905	3232	500	+	25.618888293961373	0.0
chr22	51213425	51213925	3233	500	+	25.618888293961373	0.0
chr22	51221785	51222406	3234	621	+	110.16121966403391	4.570237698062677
chr22	51225305	51225805	3235	500	+	30.742665952753647	0.0
chr22	51239405	51239905	3236	500	+	17.93322180577296	0.0
